PAIR	R1	R2	WORDCLASS
ἀλήθεια/πίστις	related	distantly_related	n
ἀλήθεια/δόξα	related	distantly_related	n
ἀλήθεια/πρᾶγμα	unrelated	distantly_related	n
ἀλήθεια/διάνοια	distantly_related	distantly_related	n
ἀλήθεια/δόγμα	related	distantly_related	n
ἀλήθεια/λόγος	distantly_related	distantly_related	n
ἀλήθεια/σοφία	distantly_related	related	n
ἀλήθεια/θεός	unrelated	same_domain	n
ἀλήθεια/ἀρετή	distantly_related	distantly_related	n
ἀλήθεια/δικαιοσύνη	distantly_related	distantly_related	n
ἀλήθεια/εὐσέβεια	distantly_related	distantly_related	n
ἀλήθεια/γνῶσις	related	distantly_related	n
ἀλήθεια/φιλοσοφία	same_domain	distantly_related	n
ἀλήθεια/γνώμη	related	distantly_related	n
πέρας/γραμμή	related	related	n
πέρας/μῦς	unrelated	unrelated	n
πέρας/ὀστέον	unrelated	unrelated	n
πέρας/κύκλος	same_domain	unrelated	n
πέρας/μέρος	related	same_domain	n
πέρας/μῆκος	same_domain	same_domain	n
πέρας/ἐπιφάνεια	related	unrelated	n
πέρας/διάστημα	same_domain	same_domain	n
πέρας/πλευρά	related	distantly_related	n
πέρας/διάρθρωσις	unrelated	unrelated	n
πέρας/μόριον	related	same_domain	n
πέρας/φλέψ	unrelated	unrelated	n
πέρας/ἀπόφυσις	distantly_related	same_domain	n
πέρας/κίνησις	unrelated	same_domain	n
πέρας/ἀρχή	related	related	n
πέρας/σημεῖον	distantly_related	related	n
πέρας/μέγεθος	same_domain	related	n
πέρας/τέλος	synonym	synonym	n
πέρας/ὅρος	synonym	synonym	n
ὄνομα/ῥῆμα	synonym	synonym	n
ὄνομα/λέξις	synonym	synonym	n
ὄνομα/προσηγορία	synonym	distantly_related	n
ὄνομα/λόγος	synonym	synonym	n
ὄνομα/φωνή	related	related	n
ὄνομα/ποιητής	same_domain	same_domain	n
ὄνομα/συλλαβή	related	distantly_related	n
ὄνομα/πτῶσις	same_domain	same_domain	n
ὄνομα/γένος	same_domain	same_domain	n
ὄνομα/γραφή	same_domain	distantly_related	n
ὄνομα/πρόσωπον	same_domain	same_domain	n
ὄνομα/γράμμα	related	distantly_related	n
ὄνομα/διαφορά	unrelated	unrelated	n
ὄνομα/αἰτία	distantly_related	unrelated	n
ὄνομα/ὅρος	distantly_related	unrelated	n
ὄνομα/εἶδος	same_domain	unrelated	n
ὄνομα/πρᾶγμα	related	same_domain	n
πόλις/χώρα	related	related	n
πόλις/φρούριον	related	distantly_related	n
πόλις/πατρίς	related	distantly_related	n
πόλις/τεῖχος	same_domain	same_domain	n
πόλις/βάρβαρος	same_domain	same_domain	n
πόλις/στρατόπεδον	related	distantly_related	n
πόλις/βασιλεύς	same_domain	same_domain	n
πόλις/στρατιώτης	unrelated	same_domain	n
πόλις/πολίτης	same_domain	same_domain	n
πόλις/στρατηγός	unrelated	same_domain	n
πόλις/ἄστυ	synonym	synonym	n
πόλις/νῆσος	distantly_related	distantly_related	n
πόλις/ἔθνος	related	distantly_related	n
πόλις/οἰκία	distantly_related	distantly_related	n
πόλις/χωρίον	related	related	n
πόλις/ἐκκλησία	same_domain	distantly_related	n
πόλις/ἀκρόπολις	related	related	n
πόλις/οἶκος	distantly_related	distantly_related	n
πόλις/κώμη	related	related	n
ἀπορία/αἰτία	same_domain	same_domain	n
ἀπορία/πρᾶγμα	synonym	same_domain	n
ἀπορία/λύσις	related	same_domain	n
ἀπορία/τρόπος	distantly_related	same_domain	n
ἀπορία/ζήτησις	same_domain	distantly_related	n
ἀπορία/λόγος	unrelated	same_domain	n
ἀπορία/φιλόσοφος	same_domain	same_domain	n
ἀπορία/ἐπιχείρημα	same_domain	same_domain	n
ἀπορία/ἔνστασις	synonym	same_domain	n
ἀπορία/πρόβλημα	synonym	distantly_related	n
ἀπορία/νόσος	distantly_related	distantly_related	n
ἀπορία/ταραχή	synonym	related	n
ἀπορία/συμφορά	related	related	n
ἀπορία/φόβος	same_domain	related	n
ἀπορία/ἔνδεια	synonym	synonym	n
ἀπορία/πάθος	related	same_domain	n
ἀπορία/ὑπόθεσις	distantly_related	same_domain	n
ἀπορία/κίνδυνος	related	related	n
ἀπορία/διαφορά	distantly_related	distantly_related	n
ἀπορία/χρεία	synonym	related	n
μάχη/πόλεμος	related	related	n
μάχη/βάρβαρος	same_domain	same_domain	n
μάχη/στρατός	same_domain	same_domain	n
μάχη/ὅπλον	same_domain	same_domain	n
μάχη/στρατιώτης	same_domain	same_domain	n
μάχη/στρατόπεδον	same_domain	same_domain	n
μάχη/στράτευμα	same_domain	same_domain	n
μάχη/ἱππεύς	same_domain	same_domain	n
μάχη/στρατιά	same_domain	same_domain	n
μάχη/πολέμιος	same_domain	distantly_related	n
μάχη/ἀγών	synonym	related	n
μάχη/ναυμαχία	related	related	n
μάχη/παράταξις	synonym	same_domain	n
μάχη/νίκη	same_domain	same_domain	n
μάχη/πλῆθος	same_domain	unrelated	n
μάχη/κίνδυνος	same_domain	distantly_related	n
μάχη/φόνος	distantly_related	related	n
μάχη/πόνος	same_domain	distantly_related	n
μάχη/καιρός	unrelated	unrelated	n
μάχη/ἔργον	related	distantly_related	n
μάχη/ναῦς	same_domain	same_domain	n
ἀδελφός/υἱός	related	related	n
ἀδελφός/πατήρ	related	related	n
ἀδελφός/ἀδελφή	related	related	n
ἀδελφός/παῖς	related	related	n
ἀδελφός/θυγάτηρ	related	related	n
ἀδελφός/τέκνον	related	related	n
ἀδελφός/βασιλεύς	distantly_related	same_domain	n
ἀδελφός/γυνή	distantly_related	distantly_related	n
ἀδελφός/μήτηρ	related	distantly_related	n
ἀδελφός/κύριος	distantly_related	same_domain	n
ἀδελφός/ἀνήρ	related	distantly_related	n
ἀδελφός/ἀνεψιός	related	related	n
ἀδελφός/δεσπότης	distantly_related	same_domain	n
αἰτία/γένεσις	synonym	synonym	n
αἰτία/πρᾶγμα	synonym	same_domain	n
αἰτία/τρόπος	distantly_related	same_domain	n
αἰτία/ἀρχή	synonym	synonym	n
αἰτία/πάθος	same_domain	distantly_related	n
αἰτία/διαφορά	unrelated	same_domain	n
αἰτία/φύσις	related	synonym	n
αἰτία/ἀπορία	same_domain	same_domain	n
αἰτία/ἀνάγκη	distantly_related	related	n
αἰτία/λόγος	synonym	synonym	n
αἰτία/πρόφασις	synonym	synonym	n
αἰτία/μεταβολή	unrelated	distantly_related	n
αἰτία/λύσις	related	same_domain	n
αἰτία/σημεῖον	distantly_related	same_domain	n
αἰτία/καιρός	distantly_related	distantly_related	n
αἰτία/εἶδος	unrelated	unrelated	n
αἰτία/ὑπόθεσις	synonym	synonym	n
αἰτία/χάρις	related	same_domain	n
αἰτία/διάθεσις	unrelated	same_domain	n
ἡδονή/ἐπιθυμία	related	related	n
ἡδονή/λύπη	related	distantly_related	n
ἡδονή/βίος	unrelated	same_domain	n
ἡδονή/ἀρετή	same_domain	distantly_related	n
ἡδονή/ἔρως	related	distantly_related	n
ἡδονή/ψυχή	unrelated	distantly_related	n
ἡδονή/πάθος	distantly_related	related	n
ἡδονή/κακία	related	same_domain	n
ἡδονή/δόξα	same_domain	same_domain	n
ἡδονή/πλοῦτος	same_domain	distantly_related	n
ἡδονή/χάρις	synonym	synonym	n
ἡδονή/τρυφή	same_domain	related	n
ἡδονή/πρᾶξις	unrelated	same_domain	n
ἡδονή/κάλλος	same_domain	related	n
ἡδονή/φόβος	unrelated	same_domain	n
ἡδονή/ἐλπίς	same_domain	distantly_related	n
ἡδονή/πόνος	related	same_domain	n
καρδία/ἀρτηρία	related	distantly_related	n
καρδία/ἐγκέφαλος	related	related	n
καρδία/πνεῦμα	related	same_domain	n
καρδία/φλέψ	related	distantly_related	n
καρδία/ψυχή	synonym	related	n
καρδία/πνεύμων	related	related	n
καρδία/κεφαλή	distantly_related	related	n
καρδία/ἧπαρ	related	related	n
καρδία/φρήν	synonym	related	n
καρδία/σπλάγχνον	related	related	n
καρδία/σάρξ	related	distantly_related	n
καρδία/μόριον	related	same_domain	n
καρδία/θώραξ	related	related	n
καρδία/γαστήρ	related	related	n
καρδία/κοιλία	related	related	n
καρδία/ὀφθαλμός	distantly_related	related	n
καρδία/στόμα	distantly_related	related	n
συμφορά/θάνατος	distantly_related	related	n
συμφορά/τύχη	related	synonym	n
συμφορά/κίνδυνος	related	related	n
συμφορά/πολίτης	unrelated	same_domain	n
συμφορά/ὀργή	same_domain	distantly_related	n
συμφορά/ἐλπίς	same_domain	distantly_related	n
συμφορά/τιμωρία	unrelated	distantly_related	n
συμφορά/λύπη	same_domain	related	n
συμφορά/πόλεμος	same_domain	related	n
συμφορά/φόβος	same_domain	related	n
συμφορά/πάθος	synonym	synonym	n
συμφορά/πρᾶγμα	synonym	distantly_related	n
συμφορά/νόσος	related	related	n
συμφορά/πενία	same_domain	related	n
συμφορά/πόνος	synonym	distantly_related	n
συμφορά/ἔργον	distantly_related	distantly_related	n
ὀδούς/κεφαλή	related	distantly_related	n
ὀδούς/στόμα	related	distantly_related	n
ὀδούς/γένυς	related	distantly_related	n
ὀδούς/ὀστέον	related	distantly_related	n
ὀδούς/ὄνυξ	related	distantly_related	n
ὀδούς/θρίξ	distantly_related	distantly_related	n
ὀδούς/ὀφθαλμός	related	related	n
ὀδούς/πούς	distantly_related	distantly_related	n
ὀδούς/δέρμα	distantly_related	distantly_related	n
ὀδούς/δάκτυλος	distantly_related	distantly_related	n
ὀδούς/χεῖλος	related	related	n
ὀδούς/ἔκφυσις	related	same_domain	n
ὀδούς/χείρ	distantly_related	distantly_related	n
ὀδούς/νεῦρον	distantly_related	distantly_related	n
ὀδούς/οὖς	related	distantly_related	n
ὀδούς/μηρός	distantly_related	distantly_related	n
ὀδούς/κέρας	related	related	n
κῦμα/θάλασσα	related	related	n
κῦμα/πόντος	related	related	n
κῦμα/ἄνεμος	distantly_related	same_domain	n
κῦμα/πέλαγος	related	related	n
κῦμα/ναῦς	same_domain	same_domain	n
κῦμα/γαῖα	same_domain	same_domain	n
κῦμα/ἅλς	related	related	n
κῦμα/πέτρα	same_domain	same_domain	n
κῦμα/χθών	same_domain	same_domain	n
κῦμα/οἶδμα	synonym	synonym	n
κῦμα/ὕδωρ	related	related	n
κῦμα/κλύδων	synonym	synonym	n
κῦμα/ποταμός	related	distantly_related	n
κῦμα/νέφος	distantly_related	related	n
κῦμα/δόρυ	unrelated	unrelated	n
κῦμα/φλόξ	same_domain	related	n
κῦμα/τεῖχος	unrelated	same_domain	n
σιωπή/σιγή	synonym	synonym	n
σιωπή/ἡσυχία	synonym	synonym	n
σιωπή/ἀνήρ	unrelated	same_domain	n
σιωπή/δῆμος	unrelated	same_domain	n
σιωπή/φόβος	unrelated	unrelated	n
σιωπή/βασιλεύς	unrelated	unrelated	n
σιωπή/δικαστής	unrelated	unrelated	n
σιωπή/θάνατος	same_domain	related	n
σιωπή/θόρυβος	related	related	n
σιωπή/πρᾶγμα	unrelated	unrelated	n
σιωπή/αἰδώς	distantly_related	distantly_related	n
σιωπή/φυγή	unrelated	unrelated	n
σιωπή/νύξ	same_domain	distantly_related	n
σιωπή/σχολή	related	same_domain	n
σιωπή/δέος	unrelated	unrelated	n
σιωπή/κίνδυνος	unrelated	unrelated	n
σιωπή/τρόπος	unrelated	unrelated	n
σιωπή/χρόνος	unrelated	same_domain	n
σιωπή/ἡμέρα	unrelated	unrelated	n
σιωπή/καιρός	unrelated	unrelated	n
σιωπή/σπουδή	related	same_domain	n
σιωπή/σκότος	same_domain	distantly_related	n
σιωπή/λόγος	unrelated	same_domain	n
σιωπή/βουλή	unrelated	same_domain	n
σιωπή/ἔργον	unrelated	unrelated	n
σιωπή/εἰρήνη	distantly_related	related	n
σιωπή/βία	unrelated	unrelated	n
ἔρις/φιλονεικία	same_domain	related	n
ἔρις/πόλεμος	related	related	n
ἔρις/θυμός	same_domain	distantly_related	n
ἔρις/μάχη	related	related	n
ἔρις/φθόνος	related	related	n
ἔρις/ἀνήρ	unrelated	same_domain	n
ἔρις/φόνος	same_domain	distantly_related	n
ἔρις/ἔρως	same_domain	distantly_related	n
ἔρις/στάσις	synonym	related	n
ἔρις/βία	same_domain	distantly_related	n
ἔρις/φιλοτιμία	same_domain	distantly_related	n
ἔρις/ταραχή	distantly_related	distantly_related	n
ἔρις/ὀργή	related	related	n
ἔρις/φόβος	same_domain	distantly_related	n
ἔρις/ἅμιλλα	synonym	synonym	n
ἔρις/ἀγών	synonym	synonym	n
ἔρις/πόνος	distantly_related	same_domain	n
ἔρις/θόρυβος	distantly_related	same_domain	n
ἄγαλμα/ναός	same_domain	distantly_related	n
ἄγαλμα/ξόανον	synonym	synonym	n
ἄγαλμα/βωμός	distantly_related	distantly_related	n
ἄγαλμα/ἀνάθημα	synonym	related	n
ἄγαλμα/τέμενος	same_domain	same_domain	n
ἄγαλμα/εἰκών	synonym	synonym	n
ἄγαλμα/ἱερόν	same_domain	distantly_related	n
ἄγαλμα/ἀνδριάς	synonym	synonym	n
ἄγαλμα/εἴδωλον	synonym	distantly_related	n
ἄγαλμα/λίθος	distantly_related	related	n
ἄγαλμα/στήλη	related	related	n
ἄγαλμα/σκεῦος	distantly_related	distantly_related	n
πλοῖον/ναῦς	synonym	synonym	n
πλοῖον/τριήρης	synonym	synonym	n
πλοῖον/σκάφος	synonym	synonym	n
πλοῖον/κυβερνήτης	same_domain	distantly_related	n
πλοῖον/ναύτης	same_domain	distantly_related	n
πλοῖον/στόλος	same_domain	distantly_related	n
πλοῖον/λιμήν	same_domain	distantly_related	n
πλοῖον/θάλασσα	same_domain	distantly_related	n
πλοῖον/ὁλκάς	synonym	synonym	n
πλοῖον/ἀκάτιον	synonym	synonym	n
πλοῖον/λέμβος	synonym	synonym	n
πλοῖον/στρατιώτης	same_domain	distantly_related	n
πλοῖον/στρατιά	same_domain	distantly_related	n
πλοῖον/σῖτος	same_domain	same_domain	n
πλοῖον/ἵππος	same_domain	related	n
πλοῖον/οἰκία	unrelated	distantly_related	n
πλοῖον/χρῆμα	unrelated	same_domain	n
πλοῖον/ὅπλον	same_domain	same_domain	n
πλοῖον/στρατός	same_domain	distantly_related	n
ὗς/κύων	related	related	n
ὗς/λέων	related	distantly_related	n
ὗς/ἔλαφος	related	related	n
ὗς/βοῦς	related	related	n
ὗς/ὄρνις	distantly_related	distantly_related	n
ὗς/αἴξ	related	related	n
ὗς/ταῦρος	related	related	n
ὗς/ἰχθύς	distantly_related	distantly_related	n
ὗς/λύκος	related	distantly_related	n
ὗς/θηρίον	related	related	n
ὗς/ἵππος	related	related	n
ὗς/ζῷον	related	related	n
ὗς/πρόβατον	related	related	n
ὗς/πάρδαλις	related	distantly_related	n
ὗς/τρόπος	unrelated	unrelated	n
ὗς/ὄις	related	related	n
νεανίσκος/μειράκιον	synonym	synonym	n
νεανίσκος/ἀνήρ	related	related	n
νεανίσκος/γυνή	distantly_related	distantly_related	n
νεανίσκος/παῖς	synonym	distantly_related	n
νεανίσκος/βασιλεύς	distantly_related	distantly_related	n
νεανίσκος/νεανίας	synonym	synonym	n
νεανίσκος/στρατιώτης	distantly_related	distantly_related	n
νεανίσκος/δῆμος	unrelated	same_domain	n
νεανίσκος/ἡλικία	same_domain	distantly_related	n
νεανίσκος/παρθένος	related	related	n
νεανίσκος/οἰκέτης	synonym	related	n
νεανίσκος/πλῆθος	unrelated	unrelated	n
νεανίσκος/θυγάτηρ	distantly_related	distantly_related	n
νεανίσκος/πρέσβυς	related	distantly_related	n
νεανίσκος/πατήρ	distantly_related	distantly_related	n
νεανίσκος/ἀδελφός	distantly_related	related	n
νεανίσκος/πολίτης	distantly_related	distantly_related	n
νεανίσκος/κόρη	related	distantly_related	n
οὐλή/ἀντικνήμιον	distantly_related	distantly_related	n
οὐλή/ἔτος	unrelated	unrelated	n
οὐλή/γαστροκνημία	distantly_related	distantly_related	n
οὐλή/ὀφρύς	distantly_related	distantly_related	n
οὐλή/μέτωπον	distantly_related	distantly_related	n
οὐλή/κόλλημα	distantly_related	related	n
οὐλή/φακός	related	synonym	n
οὐλή/κόλλημα	distantly_related	related	n
οὐλή/δεσμοφύλαξ	unrelated	unrelated	n
οὐλή/μήτηρ	unrelated	unrelated	n
οὐλή/ὑπογραφεύς	unrelated	unrelated	n
οὐλή/δάκτυλος	distantly_related	distantly_related	n
οὐλή/ῥίς	distantly_related	distantly_related	n
οὐλή/γένειον	distantly_related	distantly_related	n
οὐλή/γόνυ	distantly_related	distantly_related	n
οὐλή/πῆχυς	distantly_related	distantly_related	n
οὐλή/ἀφῆλιξ	unrelated	unrelated	n
οὐλή/κνήμη	distantly_related	distantly_related	n
οὐλή/γεωργός	unrelated	unrelated	n
οὐλή/οἴδημα	related	related	n
λοχαγός/ταξίαρχος	synonym	related	n
λοχαγός/λόχος	same_domain	same_domain	n
λοχαγός/ὁπλίτης	related	distantly_related	n
λοχαγός/στρατιώτης	related	distantly_related	n
λοχαγός/στρατηγός	synonym	related	n
λοχαγός/ἱππεύς	related	distantly_related	n
λοχαγός/χιλίαρχος	synonym	related	n
λοχαγός/στράτευμα	same_domain	same_domain	n
λοχαγός/στρατιά	same_domain	same_domain	n
λοχαγός/στρατόπεδον	same_domain	same_domain	n
λοχαγός/ἡγεμών	synonym	related	n
λοχαγός/σπεῖρα	same_domain	same_domain	n
λοχαγός/πολέμαρχος	synonym	related	n
λοχαγός/ἄρχων	synonym	related	n
λοχαγός/σατράπης	distantly_related	related	n
λοχαγός/ἵππαρχος	related	related	n
λοχαγός/τριήραρχος	related	related	n
ἄχος/θυμός	related	related	n
ἄχος/ἄλγος	synonym	synonym	n
ἄχος/ἦτορ	same_domain	related	n
ἄχος/φρήν	same_domain	related	n
ἄχος/χόλος	related	related	n
ἄχος/γαῖα	unrelated	unrelated	n
ἄχος/δόμος	unrelated	unrelated	n
ἄχος/ἄναξ	unrelated	unrelated	n
ἄχος/πότμος	same_domain	related	n
ἄχος/πῆμα	same_domain	related	n
ἄχος/πένθος	synonym	synonym	n
ἄχος/γόος	same_domain	related	n
ἄχος/ἄτη	distantly_related	distantly_related	n
ἄχος/ἔπος	unrelated	unrelated	n
ἄχος/ἀυτή	same_domain	related	n
ἄχος/ἀνία	synonym	related	n
ἄχος/φάτις	unrelated	unrelated	n
ἄχος/μόρος	same_domain	related	n
ἄχος/ποθή	distantly_related	same_domain	n
ἄχος/σῆμα	unrelated	same_domain	n
ἄχος/τύμβος	unrelated	same_domain	n
ἄχος/λέκτρον	unrelated	unrelated	n
ἶρις/σμύρνα	distantly_related	distantly_related	n
ἶρις/δράξ	unrelated	unrelated	n
ἶρις/κασσία	related	same_domain	n
ἶρις/νάρδος	related	distantly_related	n
ἶρις/καρδάμωμον	related	related	n
ἶρις/κρόκος	related	distantly_related	n
ἶρις/πέπερι	distantly_related	same_domain	n
ἶρις/στυπτηρία	unrelated	distantly_related	n
ἶρις/λίβανος	distantly_related	related	n
ἶρις/γεντιανή	related	related	n
ἶρις/ὀπίας	unrelated	same_domain	n
ἶρις/κόστος	related	distantly_related	n
ἶρις/πετροσέλινον	related	related	n
ἶρις/πύρεθρον	related	related	n
ἶρις/ζιγγίβερις	related	related	n
ἶρις/μαλάβαθρον	related	related	n
ἶρις/κηκίς	distantly_related	unrelated	n
ἶρις/χαλβάνη	related	related	n
ψάμμος/ὕδωρ	distantly_related	distantly_related	n
ψάμμος/κόνις	related	related	n
ψάμμος/ἄμμος	synonym	synonym	n
ψάμμος/πηλός	related	related	n
ψάμμος/πέτρα	related	distantly_related	n
ψάμμος/λίθος	related	distantly_related	n
ψάμμος/θάλασσα	same_domain	same_domain	n
ψάμμος/γῆ	related	related	n
ψάμμος/ψάμαθος	synonym	synonym	n
ψάμμος/πηγή	same_domain	same_domain	n
ψάμμος/θίς	synonym	synonym	n
ψάμμος/τέφρα	related	related	n
ψάμμος/ἰλύς	related	related	n
ψάμμος/αἰγιαλός	related	distantly_related	n
ψάμμος/κόλπος	same_domain	same_domain	n
ψάμμος/λίμνη	same_domain	same_domain	n
ψάμμος/ὄρος	synonym	same_domain	n
ψάμμος/βοτάνη	related	same_domain	n
ψάμμος/ἀήρ	distantly_related	same_domain	n
ψάμμος/τόπος	same_domain	same_domain	n
ψάμμος/φάραγξ	same_domain	same_domain	n
ψάμμος/ξύλον	distantly_related	distantly_related	n
ἀνάμνησις/μνήμη	synonym	synonym	n
ἀνάμνησις/μάθησις	related	related	n
ἀνάμνησις/θεωρία	related	distantly_related	n
ἀνάμνησις/λόγος	distantly_related	related	n
ἀνάμνησις/ἀπόδειξις	same_domain	related	n
ἀνάμνησις/εὕρεσις	distantly_related	related	n
ἀνάμνησις/διδασκαλία	same_domain	related	n
ἀνάμνησις/ὑπόμνησις	synonym	synonym	n
ἀνάμνησις/λήθη	related	related	n
ἀνάμνησις/λογισμός	same_domain	related	n
ἀνάμνησις/ἐμπειρία	related	related	n
ἀνάμνησις/χάρις	unrelated	same_domain	n
ἀνάμνησις/θέα	related	distantly_related	n
ἀνάμνησις/ἔννοια	related	related	n
ἀνάμνησις/αἰτία	unrelated	same_domain	n
ἀνάμνησις/ἐπίδειξις	unrelated	related	n
ἀνάμνησις/γυμνασία	same_domain	same_domain	n
ἀνάμνησις/τρόπος	unrelated	unrelated	n
ἀνάμνησις/ἐπίστασις	same_domain	unrelated	n
ἀνάμνησις/δόξα	same_domain	distantly_related	n
ἀνάμνησις/καιρός	unrelated	related	n
ἀνάμνησις/ἀκολουθία	unrelated	unrelated	n
ἀνάμνησις/αἴσθησις	related	distantly_related	n
ἀνάμνησις/διόρθωσις	unrelated	same_domain	n
ἀνάμνησις/γένεσις	unrelated	unrelated	n
ἀνάμνησις/παράδειγμα	same_domain	unrelated	n
προσευχή/εὐχή	synonym	synonym	n
προσευχή/δέησις	related	related	n
προσευχή/νηστεία	same_domain	distantly_related	n
προσευχή/κύριος	same_domain	same_domain	n
προσευχή/θεός	same_domain	same_domain	n
προσευχή/θυσία	distantly_related	related	n
προσευχή/εὐχαριστία	same_domain	distantly_related	n
προσευχή/κρίμα	unrelated	related	n
προσευχή/ἔλεος	same_domain	distantly_related	n
προσευχή/ἱκεσία	synonym	synonym	n
προσευχή/παράκλησις	related	synonym	n
προσευχή/ἐντολή	related	distantly_related	n
προσευχή/πίστις	same_domain	distantly_related	n
προσευχή/ἐλεημοσύνη	same_domain	distantly_related	n
προσευχή/ἱκετεία	synonym	synonym	n
προσευχή/χάρις	same_domain	same_domain	n
προσευχή/ἔργον	unrelated	same_domain	n
προσευχή/διδασκαλία	unrelated	same_domain	n
προσευχή/ῥῆμα	distantly_related	distantly_related	n
προσευχή/λόγος	distantly_related	distantly_related	n
προσευχή/στεναγμός	distantly_related	distantly_related	n
προσευχή/ἐκκλησία	synonym	same_domain	n
προσευχή/ὕμνος	related	same_domain	n
προσευχή/ἀγάπη	same_domain	same_domain	n
κωμῳδία/τραγῳδία	related	related	n
κωμῳδία/ποιητής	same_domain	distantly_related	n
κωμῳδία/ὑποκριτής	same_domain	distantly_related	n
κωμῳδία/δρᾶμα	related	related	n
κωμῳδία/κωμῳδός	synonym	distantly_related	n
κωμῳδία/ὄρχησις	same_domain	related	n
κωμῳδία/ποίημα	related	related	n
κωμῳδία/θέατρον	same_domain	distantly_related	n
κωμῳδία/ῥήτωρ	same_domain	same_domain	n
κωμῳδία/μῖμος	related	distantly_related	n
κωμῳδία/σοφιστής	same_domain	same_domain	n
κωμῳδία/συγγραφεύς	same_domain	distantly_related	n
κωμῳδία/τραγῳδός	related	distantly_related	n
κωμῳδία/ἐλεγεῖον	related	distantly_related	n
κωμῳδία/φιλόσοφος	unrelated	same_domain	n
κωμῳδία/κιθαριστής	same_domain	distantly_related	n
κωμῳδία/διθύραμβος	related	distantly_related	n
κωμῳδία/μουσική	related	distantly_related	n
κωμῳδία/ἐπίγραμμα	related	same_domain	n
κωμῳδία/ἱστορία	related	same_domain	n
κωμῳδία/μῦθος	related	distantly_related	n
κωμῳδία/μελοποιός	same_domain	distantly_related	n
ταμιεῖον/οἰκία	distantly_related	distantly_related	n
ταμιεῖον/χρῆμα	same_domain	same_domain	n
ταμιεῖον/θύρα	distantly_related	distantly_related	n
ταμιεῖον/οἴκημα	synonym	distantly_related	n
ταμιεῖον/ἀγορά	distantly_related	same_domain	n
ταμιεῖον/δωμάτιον	synonym	related	n
ταμιεῖον/θησαυρός	synonym	synonym	n
ταμιεῖον/τράπεζα	related	related	n
ταμιεῖον/οἶκος	synonym	distantly_related	n
ταμιεῖον/κέλλα	synonym	related	n
ταμιεῖον/κοιτών	related	distantly_related	n
ταμιεῖον/ἀποθήκη	synonym	related	n
ταμιεῖον/ὑπερῷον	related	distantly_related	n
ταμιεῖον/πυλών	distantly_related	distantly_related	n
ταμιεῖον/εἴσοδος	distantly_related	distantly_related	n
ταμιεῖον/αὐλή	related	distantly_related	n
ταμιεῖον/σκηνή	distantly_related	distantly_related	n
ταμιεῖον/σκεῦος	distantly_related	same_domain	n
ἠιών/θάλασσα	related	distantly_related	n
ἠιών/κῦμα	same_domain	same_domain	n
ἠιών/ἀκτή	synonym	synonym	n
ἠιών/ποταμός	related	distantly_related	n
ἠιών/πόντος	related	distantly_related	n
ἠιών/πέλαγος	related	distantly_related	n
ἠιών/ναῦς	same_domain	same_domain	n
ἠιών/χθών	related	distantly_related	n
ἠιών/πέτρα	distantly_related	distantly_related	n
ἠιών/νῆσος	distantly_related	distantly_related	n
ἠιών/αἰγιαλός	synonym	synonym	n
ἠιών/ὄχθη	synonym	related	n
ἠιών/κόλπος	related	related	n
ἠιών/λιμήν	related	related	n
ἠιών/ὄρος	same_domain	distantly_related	n
ἠιών/πεδίον	synonym	distantly_related	n
ἠιών/ψάμαθος	related	distantly_related	n
ἠιών/γαῖα	related	distantly_related	n
ἠιών/τεῖχος	unrelated	distantly_related	n
ἠιών/μυχός	related	same_domain	n
δελφίς/κῦμα	same_domain	same_domain	n
δελφίς/ἰχθύς	related	related	n
δελφίς/πέλαγος	same_domain	same_domain	n
δελφίς/πόντος	same_domain	same_domain	n
δελφίς/θάλασσα	same_domain	same_domain	n
δελφίς/ἵππος	distantly_related	distantly_related	n
δελφίς/ἠιών	same_domain	same_domain	n
δελφίς/κύων	distantly_related	distantly_related	n
δελφίς/ναῦς	same_domain	same_domain	n
δελφίς/χθών	unrelated	unrelated	n
δελφίς/λέων	distantly_related	distantly_related	n
δελφίς/ἔλαφος	distantly_related	distantly_related	n
δελφίς/βοῦς	distantly_related	distantly_related	n
δελφίς/ὄρνις	distantly_related	distantly_related	n
δελφίς/ἀετός	distantly_related	distantly_related	n
δελφίς/ταῦρος	distantly_related	distantly_related	n
δελφίς/κροκόδειλος	distantly_related	related	n
δελφίς/ἀλεκτρυών	distantly_related	distantly_related	n
δελφίς/λύκος	distantly_related	distantly_related	n
δελφίς/ἄνθρωπος	distantly_related	distantly_related	n
δελφίς/δράκων	distantly_related	related	n
δελφίς/ὗς	distantly_related	distantly_related	n
δελφίς/μυῖα	distantly_related	distantly_related	n
δελφίς/ἐλέφας	distantly_related	distantly_related	n
παραφυλακή/κώμη	unrelated	unrelated	n
παραφυλακή/ἀπηλιώτης	unrelated	unrelated	n
παραφυλακή/κτῆμα	unrelated	unrelated	n
παραφυλακή/ἐποίκιον	unrelated	unrelated	n
παραφυλακή/ὑπηρεσία	unrelated	unrelated	n
παραφυλακή/παγαρχία	unrelated	unrelated	n
παραφυλακή/λίψ	unrelated	unrelated	n
παραφυλακή/νομός	unrelated	unrelated	n
παραφυλακή/δαπάνη	unrelated	unrelated	n
παραφυλακή/φόρος	unrelated	unrelated	n
παραφυλακή/γεωργία	unrelated	unrelated	n
παραφυλακή/κατασπορά	unrelated	unrelated	n
παραφυλακή/ἐργασία	unrelated	distantly_related	n
παραφυλακή/συγκομιδή	unrelated	distantly_related	n
παραφυλακή/ποτισμός	unrelated	unrelated	n
παραφυλακή/χρεία	unrelated	unrelated	n
παραφυλακή/εἰσφορά	unrelated	distantly_related	n
παραφυλακή/σπορά	unrelated	unrelated	n
παραφυλακή/ὑπουργία	unrelated	distantly_related	n
παραφυλακή/ὅριον	unrelated	unrelated	n
παραφυλακή/συμπλήρωσις	unrelated	unrelated	n
παραφυλακή/συλλογή	unrelated	distantly_related	n
παραφυλακή/ἀνακομιδή	unrelated	distantly_related	n
παραφυλακή/διαρπαγή	same_domain	same_domain	n
παραφυλακή/χειρισμός	unrelated	distantly_related	n
παραφυλακή/χρηστήριον	unrelated	unrelated	n
ἱππόδρομος/θέατρον	synonym	related	n
ἱππόδρομος/βουλευτήριον	unrelated	distantly_related	n
ἱππόδρομος/δρόμος	synonym	related	n
ἱππόδρομος/ἡρῷον	unrelated	unrelated	n
ἱππόδρομος/ὅπλον	same_domain	unrelated	n
ἱππόδρομος/ἀγορά	unrelated	related	n
ἱππόδρομος/λόφος	same_domain	same_domain	n
ἱππόδρομος/ὁπλίτης	related	same_domain	n
ἱππόδρομος/τέμενος	unrelated	same_domain	n
ἱππόδρομος/ἀγών	same_domain	same_domain	n
ἱππόδρομος/αὐλών	distantly_related	distantly_related	n
ἱππόδρομος/στοά	unrelated	same_domain	n
ἱππόδρομος/ναός	unrelated	same_domain	n
ἱππόδρομος/ἀκρόπολις	unrelated	same_domain	n
ἱππόδρομος/ἱερόν	unrelated	same_domain	n
ἱππόδρομος/ὠθισμός	unrelated	unrelated	n
ἱππόδρομος/βαλανεῖον	unrelated	unrelated	n
ἱππόδρομος/γυμνάσιον	related	unrelated	n
ἱππόδρομος/τρίοδος	related	related	n
ἱππόδρομος/πεδίον	unrelated	distantly_related	n
ἱππόδρομος/τάφος	unrelated	unrelated	n
ἱππόδρομος/βασίλειον	unrelated	same_domain	n
ἱππόδρομος/νύξ	unrelated	unrelated	n
ἱππόδρομος/πύλη	distantly_related	distantly_related	n
ἱππόδρομος/αἰγιαλός	unrelated	distantly_related	n
ἱππόδρομος/θέα	same_domain	related	n
ἱππόδρομος/ἄστυ	unrelated	distantly_related	n
ἱππόδρομος/πρυτανεῖον	unrelated	same_domain	n
οἶστρος/λύσσα	synonym	related	n
οἶστρος/πόθος	related	related	n
οἶστρος/κόρη	unrelated	unrelated	n
οἶστρος/θυμός	related	related	n
οἶστρος/ἔρως	related	related	n
οἶστρος/λέκτρον	unrelated	unrelated	n
οἶστρος/ὑμέναιος	unrelated	unrelated	n
οἶστρος/φιλότης	unrelated	distantly_related	n
οἶστρος/φρήν	same_domain	related	n
οἶστρος/νύμφη	related	unrelated	n
οἶστρος/ζῆλος	synonym	related	n
οἶστρος/ἡνιοχεύς	unrelated	unrelated	n
οἶστρος/φόβος	related	related	n
οἶστρος/μανία	synonym	related	n
οἶστρος/ἄτη	synonym	related	n
οἶστρος/ἵμερος	related	related	n
οἶστρος/ὀργή	related	related	n
οἶστρος/ἔρις	unrelated	related	n
οἶστρος/μύωψ	synonym	synonym	n
οἶστρος/ὀμφή	unrelated	unrelated	n
οἶστρος/πένθος	related	distantly_related	n
οἶστρος/δέμας	unrelated	unrelated	n
οἶστρος/χόλος	related	related	n
οἶστρος/αὐδή	unrelated	unrelated	n
οἶστρος/ἄλγος	related	related	n
οἶστρος/ἱμάσθλη	same_domain	unrelated	n
οἶστρος/ἐπιθυμία	related	related	n
ῥαφή/ὀστέον	same_domain	distantly_related	n
ῥαφή/ὑμήν	same_domain	distantly_related	n
ῥαφή/ἀπόφυσις	distantly_related	related	n
ῥαφή/νεῦρον	distantly_related	distantly_related	n
ῥαφή/τρῆμα	same_domain	related	n
ῥαφή/κάταγμα	distantly_related	related	n
ῥαφή/μῦς	same_domain	distantly_related	n
ῥαφή/κρανίον	same_domain	related	n
ῥαφή/κοιλότης	same_domain	related	n
ῥαφή/διάρθρωσις	unrelated	distantly_related	n
ῥαφή/γραμμή	related	related	n
ῥαφή/μετακάρπιον	same_domain	distantly_related	n
ῥαφή/ἀπονεύρωσις	same_domain	distantly_related	n
ῥαφή/πέρας	distantly_related	distantly_related	n
ῥαφή/μόριον	same_domain	same_domain	n
ῥαφή/κνήμη	same_domain	same_domain	n
ῥαφή/ὠμοπλάτη	same_domain	same_domain	n
ῥαφή/σύνδεσμος	related	synonym	n
ῥαφή/τένων	distantly_related	distantly_related	n
ῥαφή/διάστασις	related	related	n
ῥαφή/πλευρά	same_domain	distantly_related	n
ῥαφή/ῥάχις	same_domain	distantly_related	n
ῥαφή/σύμφυσις	related	synonym	n
ῥαφή/ὅρος	unrelated	related	n
καλοκἀγαθία/ἀρετή	synonym	synonym	n
καλοκἀγαθία/ἀνδραγαθία	synonym	synonym	n
καλοκἀγαθία/εὐδαιμονία	same_domain	related	n
καλοκἀγαθία/εὐσέβεια	related	related	n
καλοκἀγαθία/φιλοτιμία	distantly_related	related	n
καλοκἀγαθία/πλοῦτος	unrelated	same_domain	n
καλοκἀγαθία/ἐλευθερία	same_domain	distantly_related	n
καλοκἀγαθία/σωφροσύνη	related	related	n
καλοκἀγαθία/ψυχή	same_domain	same_domain	n
καλοκἀγαθία/παιδεία	same_domain	distantly_related	n
καλοκἀγαθία/μετριότης	related	related	n
καλοκἀγαθία/σύνεσις	related	related	n
καλοκἀγαθία/ἐπιεικεία	synonym	related	n
καλοκἀγαθία/μεγαλοψυχία	synonym	synonym	n
καλοκἀγαθία/ἀνδρεία	related	synonym	n
καλοκἀγαθία/πραότης	related	related	n
καλοκἀγαθία/ἐγκράτεια	related	related	n
καλοκἀγαθία/ἐπιείκεια	synonym	related	n
καλοκἀγαθία/εὔνοια	related	related	n
καλοκἀγαθία/δικαιοσύνη	related	distantly_related	n
καλοκἀγαθία/εὐτεκνία	same_domain	distantly_related	n
καλοκἀγαθία/θεοσεβεία	related	related	n
πολεμιστής/ἀνήρ	distantly_related	distantly_related	n
πολεμιστής/αἰχμητής	related	related	n
πολεμιστής/ἅρμα	same_domain	same_domain	n
πολεμιστής/πόλεμος	same_domain	same_domain	n
πολεμιστής/χιλιάς	unrelated	unrelated	n
πολεμιστής/ἡμίθεος	distantly_related	same_domain	n
πολεμιστής/ἵππος	same_domain	same_domain	n
πολεμιστής/ὅπλον	same_domain	same_domain	n
πολεμιστής/βασιλεύς	unrelated	distantly_related	n
πολεμιστής/ῥομφαία	same_domain	same_domain	n
πολεμιστής/μαχητής	synonym	synonym	n
πολεμιστής/ἀκοντιστής	related	related	n
πολεμιστής/ἄρχων	related	distantly_related	n
πολεμιστής/τοξότης	related	related	n
πολεμιστής/ὄρχαμος	related	distantly_related	n
πολεμιστής/ὁπλίτης	synonym	related	n
πολεμιστής/κοίρανος	related	distantly_related	n
πολεμιστής/ἡνίοχος	related	related	n
πολεμιστής/πρεσβύτης	unrelated	same_domain	n
πολεμιστής/ὑβριστής	distantly_related	related	n
πολεμιστής/ἀροτήρ	unrelated	same_domain	n
πολεμιστής/ἀθλητής	related	related	n
πολεμιστής/ἄωτον	same_domain	unrelated	n
πολεμιστής/δυνάστης	distantly_related	distantly_related	n
πολεμιστής/ἀγωνιστής	related	synonym	n
πολεμιστής/θεραπευτής	unrelated	same_domain	n
πολεμιστής/μετανάστης	unrelated	same_domain	n
πολεμιστής/μῶνυξ	same_domain	unrelated	n
πολεμιστής/ποιμήν	related	same_domain	n
πολεμιστής/συνωρίς	same_domain	same_domain	n
θήκη/τάφος	synonym	synonym	n
θήκη/νεκρός	same_domain	distantly_related	n
θήκη/μνῆμα	synonym	distantly_related	n
θήκη/σορός	related	synonym	n
θήκη/λάρναξ	synonym	synonym	n
θήκη/ναός	same_domain	same_domain	n
θήκη/μνημεῖον	synonym	distantly_related	n
θήκη/σκεῦος	related	related	n
θήκη/ἀνάθημα	unrelated	distantly_related	n
θήκη/ἱερόν	same_domain	same_domain	n
θήκη/κιβώτιον	synonym	synonym	n
θήκη/ὅπλον	unrelated	distantly_related	n
θήκη/κίστη	synonym	synonym	n
θήκη/λείψανον	same_domain	distantly_related	n
θήκη/κλίνη	related	distantly_related	n
θήκη/κευθμών	related	related	n
θήκη/ταφή	synonym	synonym	n
θήκη/ἑστία	same_domain	unrelated	n
θήκη/τέμενος	same_domain	same_domain	n
θήκη/βωμός	synonym	distantly_related	n
θήκη/νῆσος	unrelated	unrelated	n
θήκη/βίβλος	unrelated	same_domain	n
ἑστίασις/δεῖπνον	related	related	n
ἑστίασις/εὐωχία	synonym	synonym	n
ἑστίασις/θυσία	related	related	n
ἑστίασις/φιλοφροσύνη	same_domain	same_domain	n
ἑστίασις/πομπή	distantly_related	distantly_related	n
ἑστίασις/πανήγυρις	related	distantly_related	n
ἑστίασις/ξένιον	synonym	same_domain	n
ἑστίασις/ἑορτή	synonym	synonym	n
ἑστίασις/πότος	related	synonym	n
ἑστίασις/συμπόσιον	related	synonym	n
ἑστίασις/θοίνη	synonym	related	n
ἑστίασις/θέα	distantly_related	same_domain	n
ἑστίασις/σύλλογος	distantly_related	related	n
ἑστίασις/ταφή	unrelated	distantly_related	n
ἑστίασις/σπουδή	unrelated	same_domain	n
ἑστίασις/τράπεζα	same_domain	same_domain	n
ἑστίασις/ἀγών	distantly_related	related	n
σκοπιά/ὄρος	related	related	n
σκοπιά/πρών	related	distantly_related	n
σκοπιά/λόφος	related	related	n
σκοπιά/πόντος	same_domain	distantly_related	n
σκοπιά/πέτρα	related	related	n
σκοπιά/χθών	same_domain	distantly_related	n
σκοπιά/γαῖα	same_domain	distantly_related	n
σκοπιά/χῶρος	same_domain	distantly_related	n
σκοπιά/κέλευθος	same_domain	distantly_related	n
σκοπιά/θήρ	unrelated	same_domain	n
σκοπιά/δένδρεον	unrelated	distantly_related	n
σκοπιά/πτολίεθρον	distantly_related	related	n
σκοπιά/ὄχθος	related	related	n
σκοπιά/δῶμα	unrelated	distantly_related	n
σκοπιά/ἄστυ	unrelated	distantly_related	n
σκοπιά/κορυφή	synonym	related	n
σκοπιά/περιωπή	synonym	synonym	n
σκοπιά/θίς	same_domain	related	n
σκοπιά/βουνός	related	related	n
σκοπιά/οὖδας	related	distantly_related	n
σκοπιά/κράς	synonym	related	n
σκοπιά/μυχός	distantly_related	distantly_related	n
σκοπιά/πεδίον	same_domain	distantly_related	n
σκοπιά/ἀκρώρεια	related	related	n
σκοπιά/αἰγιαλός	same_domain	distantly_related	n
σκοπιά/κολωνός	synonym	related	n
σκοπιά/ἠιών	same_domain	distantly_related	n
σκοπιά/λίμνη	same_domain	same_domain	n
σκοπιά/πύργος	synonym	related	n
πέδιλον/ταρσός	related	related	n
πέδιλον/θύρσος	distantly_related	unrelated	n
πέδιλον/παλάμη	unrelated	related	n
πέδιλον/χθών	unrelated	same_domain	n
πέδιλον/πούς	related	synonym	n
πέδιλον/γαῖα	unrelated	same_domain	n
πέδιλον/κάρηνον	unrelated	distantly_related	n
πέδιλον/εἷμα	related	related	n
πέδιλον/κνημίς	related	related	n
πέδιλον/δόμος	unrelated	same_domain	n
πέδιλον/πτέρυξ	unrelated	distantly_related	n
πέδιλον/τόξον	distantly_related	distantly_related	n
πέδιλον/ἀσπίς	distantly_related	distantly_related	n
πέδιλον/θυρεός	distantly_related	distantly_related	n
πέδιλον/χλαμύς	distantly_related	related	n
πέδιλον/πτερόν	unrelated	distantly_related	n
πέδιλον/φαρέτρα	distantly_related	distantly_related	n
πέδιλον/δόρυ	distantly_related	distantly_related	n
πέδιλον/κράνος	distantly_related	related	n
πέδιλον/λόγχη	distantly_related	distantly_related	n
πέδιλον/φᾶρος	distantly_related	related	n
πέδιλον/ὑπόδημα	synonym	synonym	n
πέδιλον/πῖλος	related	distantly_related	n
πέδιλον/πορφυρίς	distantly_related	related	n
πέδιλον/τεῦχος	distantly_related	related	n
πέδιλον/δοράτιον	distantly_related	distantly_related	n
πέδιλον/χιτωνίσκος	distantly_related	related	n
πέδιλον/ζώνη	distantly_related	related	n
πέδιλον/ἐνώτιον	distantly_related	related	n
πέδιλον/ἔθειρα	unrelated	distantly_related	n
πέδιλον/σκευή	related	related	n
πέδιλον/δίφρος	unrelated	same_domain	n
πέδιλον/ἱμάτιον	distantly_related	related	n
πέδιλον/χιτών	distantly_related	related	n
ἀκρόαμα/πύκτης	distantly_related	unrelated	n
ἀκρόαμα/μουσική	synonym	distantly_related	n
ἀκρόαμα/παιδιή	same_domain	same_domain	n
ἀκρόαμα/θέαμα	related	distantly_related	n
ἀκρόαμα/τραγῳδός	related	same_domain	n
ἀκρόαμα/ἄκουσμα	synonym	synonym	n
ἀκρόαμα/θέατρον	same_domain	same_domain	n
ἀκρόαμα/σκῶμμα	same_domain	same_domain	n
ἀκρόαμα/τέρψις	same_domain	distantly_related	n
ἀκρόαμα/κιθαρῳδός	synonym	same_domain	n
ἀκρόαμα/φιλοφροσύνη	same_domain	unrelated	n
ἀκρόαμα/θεατής	distantly_related	same_domain	n
ἀκρόαμα/κωμῳδός	related	same_domain	n
ἀκρόαμα/ἡδονή	same_domain	same_domain	n
ἀκρόαμα/πανήγυρις	same_domain	same_domain	n
ἀκρόαμα/μολπή	synonym	distantly_related	n
ἀκρόαμα/παρών	unrelated	unrelated	n
ἀκρόαμα/ᾠδή	synonym	related	n
ἀκρόαμα/φόρμιγξ	same_domain	same_domain	n
ἀκρόαμα/αὐλητής	synonym	same_domain	n
ἀκρόαμα/θαλία	same_domain	same_domain	n
ἀκρόαμα/εἰλαπίνη	same_domain	same_domain	n
ἀκρόαμα/ἀοιδή	synonym	related	n
ἀκρόαμα/ἄθροισμα	unrelated	same_domain	n
ἀκρόαμα/αὐλός	same_domain	same_domain	n
ἀκρόαμα/συμφωνία	synonym	same_domain	n
ἀκρόαμα/στῦψις	unrelated	unrelated	n
ἀκρόαμα/ἱπποδρομία	unrelated	unrelated	n
ἀκρόαμα/ὀφειλέτης	unrelated	unrelated	n
ἀκρόαμα/ψεῦσμα	unrelated	distantly_related	n
ἀκρόαμα/παιδοτρίβης	unrelated	unrelated	n
ἅρπαγμα/μῶμος	unrelated	distantly_related	n
ἅρπαγμα/βδέλυγμα	unrelated	distantly_related	n
ἅρπαγμα/ἀδικία	unrelated	distantly_related	n
ἅρπαγμα/κρῖμα	unrelated	unrelated	n
ἅρπαγμα/προσήλυτος	unrelated	same_domain	n
ἅρπαγμα/ἐλεημοσύνη	unrelated	same_domain	n
ἅρπαγμα/κενοδοξία	unrelated	distantly_related	n
ἅρπαγμα/ἀνομία	unrelated	distantly_related	n
ἅρπαγμα/πτωχός	unrelated	same_domain	n
ἅρπαγμα/πλοῦτος	unrelated	distantly_related	n
ἅρπαγμα/κέλης	unrelated	unrelated	n
ἅρπαγμα/ἀχαριστία	unrelated	distantly_related	n
ἅρπαγμα/βδελυρία	unrelated	distantly_related	n
ἅρπαγμα/γενετή	unrelated	unrelated	n
ἅρπαγμα/αἴλουρος	unrelated	same_domain	n
ἅρπαγμα/δοκεύς	unrelated	unrelated	n
ἅρπαγμα/ἀλλοτρίωσις	unrelated	related	n
ἅρπαγμα/ὑποτύπωσις	unrelated	unrelated	n
ἅρπαγμα/προδότης	unrelated	same_domain	n
ἅρπαγμα/ἐπιθυμητής	unrelated	same_domain	n
ἅρπαγμα/βλάβη	unrelated	related	n
ἅρπαγμα/εἰδωλολατρεία	unrelated	same_domain	n
ἅρπαγμα/προκάλυμμα	unrelated	same_domain	n
ἅρπαγμα/ἀπάντησις	unrelated	same_domain	n
ἅρπαγμα/διπλασιασμός	unrelated	unrelated	n
ἅρπαγμα/παρανάλωμα	unrelated	related	n
ἅρπαγμα/οἰκιστής	unrelated	unrelated	n
ἅρπαγμα/ὑποπόδιον	unrelated	unrelated	n
ἅρπαγμα/πρόβολος	same_domain	unrelated	n
ἅρπαγμα/βορά	synonym	distantly_related	n
ἅρπαγμα/καταφυγή	unrelated	same_domain	n
ἅρπαγμα/παραμύθιον	unrelated	unrelated	n
ἅρπαγμα/ἄκοιτις	unrelated	unrelated	n
ἅρπαγμα/συναγωνιστής	unrelated	unrelated	n
ἅρπαγμα/ἔκτεισις	unrelated	distantly_related	n
ἅρπαγμα/ματαιότης	unrelated	distantly_related	n
ἅρπαγμα/ὄφλημα	unrelated	distantly_related	n
ἅρπαγμα/δάνεισμα	unrelated	distantly_related	n
ἅρπαγμα/χλιδή	unrelated	same_domain	n
ἅρπαγμα/εὐχέρεια	unrelated	same_domain	n
ἅρπαγμα/ἀπληστία	unrelated	distantly_related	n
στρύχνον/χυλός	same_domain	distantly_related	n
στρύχνον/ὄξος	unrelated	distantly_related	n
στρύχνον/σμύρνα	distantly_related	related	n
στρύχνον/κυκλάμινος	related	related	n
στρύχνον/ἀνδράχνη	related	related	n
στρύχνον/ἀφέψημα	same_domain	distantly_related	n
στρύχνον/μέλι	unrelated	distantly_related	n
στρύχνον/στέαρ	unrelated	same_domain	n
στρύχνον/βούτυρον	related	same_domain	n
στρύχνον/ἀρνόγλωσσον	related	related	n
στρύχνον/μάραθρον	related	related	n
στρύχνον/κράμβη	related	related	n
στρύχνον/λύκιον	related	related	n
στρύχνον/τεῦτλον	related	related	n
στρύχνον/πήγανον	related	related	n
στρύχνον/γεντιανή	related	related	n
στρύχνον/ὀξύκρατον	unrelated	distantly_related	n
στρύχνον/καλαμίνθη	related	related	n
στρύχνον/ὑοσκύαμος	related	related	n
στρύχνον/γλυκύρριζα	related	distantly_related	n
στρύχνον/πτισάνης	unrelated	same_domain	n
στρύχνον/πολύγονον	related	unrelated	n
στρύχνον/ὄμφαξ	distantly_related	distantly_related	n
γάρος/οἶνος	related	distantly_related	n
γάρος/κνίδιον	same_domain	distantly_related	n
γάρος/κεράμιον	same_domain	same_domain	n
γάρος/ἔλαιον	related	related	n
γάρος/ὀρνίθιον	distantly_related	same_domain	n
γάρος/λάχανον	distantly_related	distantly_related	n
γάρος/ὄξος	related	related	n
γάρος/ἕψημα	related	distantly_related	n
γάρος/ἄνηθον	distantly_related	distantly_related	n
γάρος/ψωμίον	distantly_related	same_domain	n
γάρος/μύρον	distantly_related	synonym	n
γάρος/σίλφιον	related	same_domain	n
γάρος/μέλι	related	related	n
γάρος/ξέστης	same_domain	unrelated	n
γάρος/σίναπι	related	related	n
γάρος/λάγυνος	same_domain	same_domain	n
γάρος/ὀψάριον	related	related	n
γάρος/τυρός	distantly_related	related	n
γάρος/δίχωρον	same_domain	distantly_related	n
γάρος/ἴνος	unrelated	same_domain	n
πρόβασις/ἀριθμός	same_domain	related	n
πρόβασις/δυάς	same_domain	distantly_related	n
πρόβασις/τριάς	same_domain	distantly_related	n
πρόβασις/μονάς	same_domain	distantly_related	n
πρόβασις/ὀγδοάς	same_domain	distantly_related	n
πρόβασις/ἑξάς	same_domain	distantly_related	n
πρόβασις/πρόβατον	same_domain	synonym	n
πρόβασις/τετράς	same_domain	distantly_related	n
πρόβασις/πεντάς	same_domain	distantly_related	n
πρόβασις/πρόσθεσις	synonym	same_domain	n
πρόβασις/ἀνάστημα	related	same_domain	n
πρόβασις/ὀκτάεδρον	same_domain	unrelated	n
πρόβασις/δμώς	unrelated	unrelated	n
πρόβασις/ποσότης	same_domain	related	n
πρόβασις/ἑνάς	same_domain	related	n
πρόβασις/πολλαπλασιασμός	distantly_related	same_domain	n
πρόβασις/ἰδίωμα	unrelated	same_domain	n
πρόβασις/δωδεκατημόριον	same_domain	unrelated	n
πρόβασις/διάμετρος	same_domain	unrelated	n
πρόβασις/ἀναλογία	same_domain	same_domain	n
πρόβασις/προκοπή	synonym	unrelated	n
πρόβασις/ἀμφώδων	unrelated	unrelated	n
πρόβασις/ὄντα	unrelated	same_domain	n
πρόβασις/περίοδος	same_domain	unrelated	n
πρόβασις/μάνδρα	same_domain	same_domain	n
πρόβασις/οὖθαρ	same_domain	same_domain	n
πρόβασις/ἀπαρίθμησις	distantly_related	same_domain	n
πρόβασις/ἐπιγονή	synonym	same_domain	n
πρόβασις/διαρπαγή	unrelated	same_domain	n
πρόβασις/ἀποβολή	related	same_domain	n
πρόβασις/κολωνός	unrelated	unrelated	n
πρόβασις/ἐπιθυμητής	unrelated	unrelated	n
πρόβασις/ἀφαίρεσις	related	same_domain	n
πρόβασις/ἡμιτόνιον	same_domain	unrelated	n
πρόβασις/σύνθεσις	related	distantly_related	n
πρόβασις/κύβος	same_domain	unrelated	n
ἔλασις/στράτευμα	synonym	distantly_related	n
ἔλασις/πορεία	synonym	distantly_related	n
ἔλασις/ὁδοιπορία	related	distantly_related	n
ἔλασις/ἔφοδος	same_domain	distantly_related	n
ἔλασις/στρατιώτης	same_domain	same_domain	n
ἔλασις/τάχος	same_domain	same_domain	n
ἔλασις/στρατόπεδον	same_domain	same_domain	n
ἔλασις/δρόμος	related	distantly_related	n
ἔλασις/στρατιά	synonym	same_domain	n
ἔλασις/χώρα	unrelated	same_domain	n
ἔλασις/ἁρπαγή	related	related	n
ἔλασις/ἀγός	same_domain	same_domain	n
ἔλασις/ἄρχων	same_domain	same_domain	n
ἔλασις/προσβολή	distantly_related	distantly_related	n
ἔλασις/χρησμός	unrelated	unrelated	n
ἔλασις/ἀγέλη	same_domain	same_domain	n
ἔλασις/δικτάτωρ	unrelated	same_domain	n
ἔλασις/συμμαχία	same_domain	unrelated	n
ἔλασις/ἧσσα	same_domain	distantly_related	n
ἔλασις/ἔκπλοος	distantly_related	related	n
ἔλασις/ὁρμή	distantly_related	related	n
ἔλασις/ἐκστρατεία	synonym	related	n
ἔλασις/θάλψις	unrelated	unrelated	n
ἔλασις/μήνιμα	unrelated	unrelated	n
ἔλασις/βλεφαρίς	unrelated	unrelated	n
ἔλασις/δίωξις	distantly_related	related	n
ἔλασις/ἄπολις	same_domain	same_domain	n
ἔλασις/κάμψις	unrelated	distantly_related	n
ἔλασις/σεισμός	unrelated	distantly_related	n
ἔλασις/ἐκδρομή	related	synonym	n
ἔλασις/ἔλευσις	related	related	n
ἔλασις/κνησμός	unrelated	distantly_related	n
ἔλασις/συριγμός	unrelated	unrelated	n
ἔλασις/ἄφιξις	distantly_related	distantly_related	n
ἔλασις/ἐξαγωγή	synonym	related	n
ἔλασις/ἐκδίκησις	unrelated	distantly_related	n
ἔλασις/γέρρον	unrelated	unrelated	n
εὔπλοια/κυβερνήτης	same_domain	same_domain	n
εὔπλοια/εἰρεσία	same_domain	distantly_related	n
εὔπλοια/πλόος	related	related	n
εὔπλοια/εὐδία	related	distantly_related	n
εὔπλοια/πρῷρα	same_domain	same_domain	n
εὔπλοια/χειμών	same_domain	same_domain	n
εὔπλοια/πομπός	same_domain	same_domain	n
εὔπλοια/ὁλκάς	same_domain	same_domain	n
εὔπλοια/ναυαγία	related	distantly_related	n
εὔπλοια/ναῦς	same_domain	same_domain	n
εὔπλοια/ὁλοκληρία	unrelated	distantly_related	n
εὔπλοια/εὐνομία	same_domain	related	n
εὔπλοια/ἐπανόρθωσις	unrelated	distantly_related	n
εὔπλοια/αὐτάρκεια	unrelated	distantly_related	n
εὔπλοια/ἀποτροπή	unrelated	distantly_related	n
εὔπλοια/συνεργία	unrelated	distantly_related	n
εὔπλοια/εὐετηρία	distantly_related	distantly_related	n
εὔπλοια/νῖκος	unrelated	same_domain	n
εὔπλοια/ὑγίεια	unrelated	distantly_related	n
εὔπλοια/πορθμεῖον	same_domain	same_domain	n
εὔπλοια/νίκη	unrelated	distantly_related	n
εὔπλοια/βοήθεια	same_domain	distantly_related	n
εὔπλοια/εὐχή	same_domain	distantly_related	n
εὔπλοια/εὐθυμία	unrelated	related	n
εὔπλοια/ἀταραξία	distantly_related	related	n
εὔπλοια/ἀσφάλεια	distantly_related	related	n
εὔπλοια/ἐπίδειξις	unrelated	unrelated	n
εὔπλοια/ἐντυχία	unrelated	unrelated	n
εὔπλοια/εὐαισθησία	unrelated	same_domain	n
εὔπλοια/ἐπικουρία	same_domain	distantly_related	n
εὔπλοια/κατόρθωσις	distantly_related	distantly_related	n
εὔπλοια/ἐκστρατεία	distantly_related	distantly_related	n
εἰδωλολατρία/πορνεία	synonym	distantly_related	n
εἰδωλολατρία/οἰνοφλυγία	unrelated	distantly_related	n
εἰδωλολατρία/μοιχεία	unrelated	distantly_related	n
εἰδωλολατρία/ψευδομαρτυρία	distantly_related	distantly_related	n
εἰδωλολατρία/πλάνη	same_domain	related	n
εἰδωλολατρία/ἀσέλγεια	distantly_related	distantly_related	n
εἰδωλολατρία/δεισιδαιμονία	related	related	n
εἰδωλολατρία/ἀνομία	distantly_related	distantly_related	n
εἰδωλολατρία/ἀκαθαρσία	related	distantly_related	n
εἰδωλολατρία/μιαιφονία	unrelated	distantly_related	n
εἰδωλολατρία/παραφυάς	unrelated	same_domain	n
εἰδωλολατρία/αἵρεσις	same_domain	synonym	n
εἰδωλολατρία/βλασφημία	related	related	n
εἰδωλολατρία/ἐπιθυμία	unrelated	distantly_related	n
εἰδωλολατρία/αὐτόχειρ	unrelated	same_domain	n
εἰδωλολατρία/ἀκολασία	distantly_related	distantly_related	n
εἰδωλολατρία/ἱερόσυλος	same_domain	same_domain	n
εἰδωλολατρία/κενοδοξία	distantly_related	related	n
εἰδωλολατρία/χορευτής	same_domain	unrelated	n
εἰδωλολατρία/κακοτεχνία	distantly_related	unrelated	n
εἰδωλολατρία/κοσμοποιία	same_domain	same_domain	n
εἰδωλολατρία/συκοφαντία	distantly_related	distantly_related	n
εἰδωλολατρία/θρησκεία	related	related	n
εἰδωλολατρία/ἰσηγορία	unrelated	unrelated	n
εἰδωλολατρία/κῶμος	same_domain	same_domain	n
εἰδωλολατρία/κίναιδος	unrelated	unrelated	n
εἰδωλολατρία/ἀνθύπατος	unrelated	unrelated	n
εἰδωλολατρία/πταρμός	unrelated	unrelated	n
εἰδωλολατρία/φλυαρία	distantly_related	distantly_related	n
εἰδωλολατρία/γόης	same_domain	same_domain	n
ὀποβάλσαμον/νάρδος	related	related	n
ὀποβάλσαμον/γεντιανή	distantly_related	distantly_related	n
ὀποβάλσαμον/χαλβάνη	synonym	distantly_related	n
ὀποβάλσαμον/μαστίχη	related	related	n
ὀποβάλσαμον/σμύρνα	synonym	distantly_related	n
ὀποβάλσαμον/κρόκος	distantly_related	related	n
ὀποβάλσαμον/ἡμίλιτρον	unrelated	unrelated	n
ὀποβάλσαμον/δράξ	unrelated	same_domain	n
ὀποβάλσαμον/πέπερι	distantly_related	related	n
ὀποβάλσαμον/κιννάμωμον	distantly_related	related	n
ὀποβάλσαμον/μαλάβαθρον	distantly_related	distantly_related	n
ὀποβάλσαμον/ζιγγίβερις	distantly_related	distantly_related	n
ὀποβάλσαμον/γλυκύρριζα	related	related	n
ὀποβάλσαμον/λίβανος	synonym	distantly_related	n
ὀποβάλσαμον/ῥητίνη	synonym	related	n
ὀποβάλσαμον/λάδανον	synonym	related	n
ὀποβάλσαμον/εὐφόρβιον	synonym	related	n
ὀποβάλσαμον/ἀφρόνιτρον	distantly_related	related	n
ὀποβάλσαμον/πύρεθρον	distantly_related	distantly_related	n
ὀποβάλσαμον/ἄμωμον	distantly_related	related	n
ὀποβάλσαμον/ὄπιον	related	related	n
ὀποβάλσαμον/καρδάμωμον	distantly_related	distantly_related	n
ὀποβάλσαμον/κηκίς	synonym	distantly_related	n
ὀποβάλσαμον/κασσία	distantly_related	related	n
ἱμάσθλη/μάστιξ	synonym	synonym	n
ἱμάσθλη/παλάμη	same_domain	same_domain	n
ἱμάσθλη/ἐλατήρ	same_domain	same_domain	n
ἱμάσθλη/θέαινα	unrelated	unrelated	n
ἱμάσθλη/θύρσος	related	related	n
ἱμάσθλη/ἡνίον	synonym	related	n
ἱμάσθλη/κάρηνον	unrelated	same_domain	n
ἱμάσθλη/ἀπήνη	same_domain	same_domain	n
ἱμάσθλη/ἡνιοχεύς	same_domain	same_domain	n
ἱμάσθλη/δίφρος	same_domain	same_domain	n
ἱμάσθλη/ἐγχείη	related	related	n
ἱμάσθλη/στροφάλιγξ	same_domain	same_domain	n
ἱμάσθλη/αἰγίς	same_domain	distantly_related	n
ἱμάσθλη/παλμός	same_domain	same_domain	n
ἱμάσθλη/ῥιπή	same_domain	same_domain	n
ἱμάσθλη/κύπελλον	unrelated	same_domain	n
ἱμάσθλη/μενοινή	unrelated	unrelated	n
ἱμάσθλη/ἄορ	related	related	n
ἱμάσθλη/δάπεδον	unrelated	distantly_related	n
ἱμάσθλη/τρίαινα	related	related	n
ἱμάσθλη/δόρυ	related	related	n
ἱμάσθλη/ὀχεύς	related	distantly_related	n
ἱμάσθλη/ἐρετμός	same_domain	distantly_related	n
ἱμάσθλη/ἔγχος	related	related	n
ἱμάσθλη/βέλεμνον	related	related	n
δοκέω/νομίζω	synonym	synonym	v
δοκέω/οἴομαι	synonym	synonym	v
δοκέω/ἡγέομαι	synonym	synonym	v
δοκέω/βούλομαι	related	related	v
δοκέω/δεῖ	related	distantly_related	v
δοκέω/ἐπιχειρέω	unrelated	unrelated	v
δοκέω/φάσκω	related	unrelated	v
δοκέω/χρή	related	distantly_related	v
δοκέω/ἀξιόω	synonym	related	v
δοκέω/πειράω	same_domain	same_domain	v
δοκέω/δύναμαι	distantly_related	unrelated	v
δοκέω/φημί	distantly_related	same_domain	v
δοκέω/δέω	related	distantly_related	v
δοκέω/μέλλω	related	related	v
δοκέω/ἐθέλω	related	related	v
δοκέω/κελεύω	distantly_related	same_domain	v
δοκέω/οἶδα	related	distantly_related	v
συμβαίνω/εἰμί	unrelated	related	v
συμβαίνω/ὑπόκειμαι	distantly_related	related	v
συμβαίνω/θεωρέω	unrelated	unrelated	v
συμβαίνω/ἐνδέχομαι	related	distantly_related	v
συμβαίνω/ὁρίζω	distantly_related	unrelated	v
συμβαίνω/ὑπάρχω	same_domain	related	v
συμβαίνω/κατηγορέω	same_domain	unrelated	v
συμβαίνω/λέγω	unrelated	unrelated	v
συμβαίνω/δείκνυμι	unrelated	unrelated	v
συμβαίνω/διαφέρω	unrelated	same_domain	v
συμβαίνω/συμπίτνω	synonym	related	v
συμβαίνω/ἕπομαι	unrelated	distantly_related	v
συμβαίνω/σημαίνω	unrelated	unrelated	v
συμβαίνω/πάσχω	unrelated	related	v
συμβαίνω/δύναμαι	same_domain	unrelated	v
συμβαίνω/προερέω	same_domain	unrelated	v
συμβαίνω/ἀντίκειμαι	related	distantly_related	v
συμβαίνω/μέλλω	unrelated	unrelated	v
συμβαίνω/δέω	same_domain	unrelated	v
συμβαίνω/χρή	same_domain	unrelated	v
συμβαίνω/προσήκω	related	distantly_related	v
συμβαίνω/φύω	distantly_related	unrelated	v
συμβαίνω/δοκέω	unrelated	unrelated	v
καλέω/ὀνομάζω	synonym	synonym	v
καλέω/προσαγορεύω	synonym	synonym	v
καλέω/οἰκέω	same_domain	unrelated	v
καλέω/κεῖμαι	unrelated	unrelated	v
καλέω/φημί	distantly_related	related	v
καλέω/χράομαι	unrelated	unrelated	v
καλέω/φέρω	unrelated	unrelated	v
καλέω/ἄγω	unrelated	unrelated	v
καλέω/ἄρχω	unrelated	unrelated	v
καλέω/ἔρχομαι	unrelated	unrelated	v
καλέω/τίθημι	unrelated	unrelated	v
καλέω/διαφέρω	unrelated	unrelated	v
καλέω/συνίστημι	same_domain	unrelated	v
καλέω/εἰμί	distantly_related	unrelated	v
καλέω/προερέω	distantly_related	distantly_related	v
καλέω/περιέχω	unrelated	unrelated	v
καλέω/ἐπικαλέω	synonym	related	v
καλέω/ἐπονομάζω	synonym	distantly_related	v
καλέω/παράκειμαι	unrelated	unrelated	v
καλέω/ἔχω	unrelated	unrelated	v
καλέω/σημαίνω	unrelated	distantly_related	v
καλέω/παραλαμβάνω	related	unrelated	v
φημί/λέγω	synonym	synonym	v
φημί/οἴομαι	related	same_domain	v
φημί/ἔοικα	same_domain	unrelated	v
φημί/καλέω	distantly_related	related	v
φημί/φάσκω	synonym	synonym	v
φημί/δοκέω	distantly_related	same_domain	v
φημί/ἀκούω	related	same_domain	v
φημί/διδάσκω	related	related	v
φημί/ὀνομάζω	distantly_related	related	v
φημί/ἐρωτάω	related	distantly_related	v
φημί/οἶδα	related	unrelated	v
φημί/νομίζω	related	same_domain	v
φημί/χρή	unrelated	unrelated	v
φημί/κελεύω	related	related	v
φημί/δέω	unrelated	unrelated	v
φημί/δύναμαι	unrelated	unrelated	v
φημί/ἀξιόω	related	same_domain	v
φημί/πειράω	unrelated	same_domain	v
φημί/θέλω	unrelated	same_domain	v
φημί/βούλομαι	unrelated	same_domain	v
φημί/μέλλω	unrelated	same_domain	v
φημί/ἐθέλω	unrelated	same_domain	v
ὁράω/βλέπω	synonym	synonym	v
ὁράω/φαίνω	same_domain	same_domain	v
ὁράω/θεάομαι	synonym	synonym	v
ὁράω/ἀκούω	related	distantly_related	v
ὁράω/ἵστημι	unrelated	unrelated	v
ὁράω/ἔρχομαι	unrelated	unrelated	v
ὁράω/ἔοικα	same_domain	same_domain	v
ὁράω/φεύγω	unrelated	unrelated	v
ὁράω/ἀνίστημι	unrelated	unrelated	v
ὁράω/φοβέω	same_domain	unrelated	v
ὁράω/θαυμάζω	related	unrelated	v
ὁράω/κάθημαι	unrelated	unrelated	v
ὁράω/ἐφίστημι	unrelated	unrelated	v
ὁράω/θεωρέω	synonym	related	v
ὁράω/γιγνώσκω	related	distantly_related	v
ὁράω/αἰσθάνομαι	synonym	synonym	v
ὁράω/οἶδα	same_domain	distantly_related	v
ὁράω/δοκέω	same_domain	unrelated	v
ὁράω/νομίζω	same_domain	unrelated	v
ὁράω/φημί	unrelated	unrelated	v
ὁράω/δύναμαι	unrelated	unrelated	v
ὁράω/οἴομαι	same_domain	same_domain	v
ὁράω/θεάω	synonym	synonym	v
ὁράω/εὑρίσκω	same_domain	related	v
ὁράω/μανθάνω	related	related	v
μένω/ἵστημι	distantly_related	distantly_related	v
μένω/φυλάσσω	distantly_related	distantly_related	v
μένω/ἐάω	distantly_related	distantly_related	v
μένω/διαμένω	synonym	synonym	v
μένω/φέρω	unrelated	unrelated	v
μένω/ἐθέλω	unrelated	unrelated	v
μένω/μέλλω	unrelated	unrelated	v
μένω/δύναμαι	unrelated	unrelated	v
μένω/κατέχω	distantly_related	distantly_related	v
μένω/κεῖμαι	distantly_related	related	v
μένω/εἶμι	unrelated	distantly_related	v
μένω/χωρέω	unrelated	distantly_related	v
μένω/ἔρχομαι	unrelated	distantly_related	v
μένω/δέχομαι	unrelated	unrelated	v
μένω/ὑπομένω	synonym	synonym	v
μένω/συνίστημι	unrelated	distantly_related	v
μένω/διαφθείρω	unrelated	unrelated	v
μένω/ἥκω	unrelated	distantly_related	v
μένω/καθίστημι	distantly_related	distantly_related	v
μένω/μεταβάλλω	related	unrelated	v
μένω/καταλαμβάνω	unrelated	unrelated	v
ἵστημι/βάλλω	distantly_related	unrelated	v
ἵστημι/κάθημαι	related	same_domain	v
ἵστημι/πίπτω	distantly_related	same_domain	v
ἵστημι/βαίνω	unrelated	same_domain	v
ἵστημι/κεῖμαι	related	same_domain	v
ἵστημι/εἶμι	unrelated	unrelated	v
ἵστημι/ἔρχομαι	unrelated	same_domain	v
ἵστημι/ὁράω	unrelated	unrelated	v
ἵστημι/τίθημι	synonym	related	v
ἵστημι/φέρω	unrelated	unrelated	v
ἵστημι/ἐφίστημι	synonym	synonym	v
ἵστημι/ἄγω	unrelated	unrelated	v
ἵστημι/μένω	distantly_related	distantly_related	v
ἵστημι/ἀνίστημι	synonym	synonym	v
πάρειμι/μέλλω	related	same_domain	v
πάρειμι/παρέχω	synonym	unrelated	v
πάρειμι/κελεύω	same_domain	same_domain	v
πάρειμι/βούλομαι	same_domain	unrelated	v
πάρειμι/παρακαλέω	distantly_related	same_domain	v
πάρειμι/ἀξιόω	unrelated	same_domain	v
πάρειμι/παρέρχομαι	synonym	synonym	v
πάρειμι/πείθω	same_domain	same_domain	v
πάρειμι/ἐνίστημι	distantly_related	same_domain	v
πάρειμι/ἐθέλω	same_domain	unrelated	v
πάρειμι/ἥκω	related	related	v
πάρειμι/παραγίγνομαι	synonym	related	v
πάρειμι/πέμπω	same_domain	same_domain	v
πάρειμι/καθίστημι	unrelated	unrelated	v
πάρειμι/ἔρχομαι	distantly_related	synonym	v
πάρειμι/πράσσω	unrelated	same_domain	v
πάρειμι/προερέω	unrelated	unrelated	v
πάρειμι/πρόκειμαι	distantly_related	distantly_related	v
πάρειμι/προσήκω	related	related	v
πάρειμι/συμφέρω	unrelated	same_domain	v
πάρειμι/ζάω	unrelated	related	v
πάρειμι/ὑπόκειμαι	related	distantly_related	v
πάρειμι/ἔπειμι	synonym	related	v
κρίνω/δοκέω	related	synonym	v
κρίνω/νομίζω	related	synonym	v
κρίνω/πράσσω	unrelated	unrelated	v
κρίνω/ἀξιόω	related	synonym	v
κρίνω/τυγχάνω	unrelated	unrelated	v
κρίνω/ἡγέομαι	related	synonym	v
κρίνω/μέλλω	unrelated	distantly_related	v
κρίνω/οἴομαι	related	synonym	v
κρίνω/ἀποφαίνω	same_domain	same_domain	v
κρίνω/γιγνώσκω	synonym	same_domain	v
κρίνω/καθίστημι	same_domain	unrelated	v
κρίνω/δικάζω	synonym	synonym	v
κρίνω/ἐξετάζω	related	related	v
κρίνω/κολάζω	distantly_related	related	v
κρίνω/βουλεύω	related	related	v
κρίνω/πείθω	same_domain	distantly_related	v
κρίνω/πιστεύω	same_domain	unrelated	v
κρίνω/ζητέω	distantly_related	unrelated	v
κρίνω/ἐπαινέω	related	related	v
κρίνω/μανθάνω	same_domain	distantly_related	v
μανθάνω/διδάσκω	related	related	v
μανθάνω/οἶδα	distantly_related	related	v
μανθάνω/γιγνώσκω	synonym	synonym	v
μανθάνω/ἐπίσταμαι	related	related	v
μανθάνω/πυνθάνομαι	synonym	synonym	v
μανθάνω/οἴομαι	distantly_related	same_domain	v
μανθάνω/βούλομαι	unrelated	unrelated	v
μανθάνω/μέλλω	unrelated	unrelated	v
μανθάνω/ἀκούω	related	related	v
μανθάνω/πείθω	same_domain	unrelated	v
μανθάνω/ἐπιδείκνυμι	unrelated	unrelated	v
μανθάνω/ἀξιόω	distantly_related	distantly_related	v
μανθάνω/ἥκω	unrelated	unrelated	v
μανθάνω/νομίζω	distantly_related	same_domain	v
μανθάνω/ἀγνοέω	related	same_domain	v
μανθάνω/ἐντυγχάνω	distantly_related	related	v
μανθάνω/ὁράω	related	related	v
μανθάνω/θαυμάζω	same_domain	related	v
ἀπαντάω/κελεύω	unrelated	unrelated	v
ἀπαντάω/πυνθάνομαι	unrelated	same_domain	v
ἀπαντάω/καταλαμβάνω	synonym	unrelated	v
ἀπαντάω/μέλλω	unrelated	unrelated	v
ἀπαντάω/ἀφικνέομαι	related	same_domain	v
ἀπαντάω/ἄπειμι	distantly_related	same_domain	v
ἀπαντάω/ἥκω	related	distantly_related	v
ἀπαντάω/ἐντυγχάνω	synonym	synonym	v
ἀπαντάω/παραγίγνομαι	related	synonym	v
ἀπαντάω/παρακαλέω	same_domain	related	v
ἀπαντάω/ὁρμάω	distantly_related	same_domain	v
ἀπαντάω/καθίστημι	unrelated	unrelated	v
ἀπαντάω/παρασκευάζω	unrelated	distantly_related	v
ἀπαντάω/ἐκπέμπω	unrelated	same_domain	v
ἀπαντάω/χωρέω	distantly_related	same_domain	v
ἀπαντάω/ἔρχομαι	distantly_related	distantly_related	v
ἀπαντάω/πέμπω	same_domain	same_domain	v
ἀπαντάω/ἄγω	same_domain	same_domain	v
ἀφίημι/κελεύω	unrelated	unrelated	v
ἀφίημι/ἐάω	synonym	unrelated	v
ἀφίημι/φέρω	unrelated	same_domain	v
ἀφίημι/ἀναγκάζω	unrelated	same_domain	v
ἀφίημι/φεύγω	same_domain	same_domain	v
ἀφίημι/ἥκω	unrelated	unrelated	v
ἀφίημι/κατέχω	related	same_domain	v
ἀφίημι/παύω	unrelated	related	v
ἀφίημι/βάλλω	related	distantly_related	v
ἀφίημι/πείθω	unrelated	same_domain	v
ἀφίημι/πέμπω	synonym	related	v
ἀφίημι/ἄγω	unrelated	same_domain	v
ἀφίημι/ὁρμάω	related	distantly_related	v
ἀφίημι/ἀπολύω	synonym	related	v
ἀφίημι/ἀπάγω	related	related	v
ἀφίημι/παραδίδωμι	related	same_domain	v
ἀφίημι/δέχομαι	unrelated	unrelated	v
ἀφίημι/καθίστημι	unrelated	distantly_related	v
ἀφίημι/καταλείπω	synonym	distantly_related	v
ἀφίημι/παρέχω	related	same_domain	v
ἀφίημι/ἔρχομαι	unrelated	unrelated	v
ἀφίημι/ἀφαιρέω	related	same_domain	v
ἀφίημι/δείδω	unrelated	unrelated	v
κατασκευάζω/χράομαι	unrelated	distantly_related	v
κατασκευάζω/κοσμέω	synonym	distantly_related	v
κατασκευάζω/οἰκοδομέω	synonym	synonym	v
κατασκευάζω/δείκνυμι	unrelated	distantly_related	v
κατασκευάζω/παρασκευάζω	synonym	synonym	v
κατασκευάζω/ἀνατίθημι	related	distantly_related	v
κατασκευάζω/ἱδρύω	related	synonym	v
κατασκευάζω/ποιέω	synonym	synonym	v
κατασκευάζω/ἀποδείκνυμι	unrelated	same_domain	v
κατασκευάζω/κεῖμαι	unrelated	unrelated	v
κατασκευάζω/τίθημι	related	distantly_related	v
κατασκευάζω/εἰσάγω	unrelated	unrelated	v
κατασκευάζω/κομίζω	unrelated	distantly_related	v
κατασκευάζω/καθίστημι	synonym	same_domain	v
κατασκευάζω/συνάγω	unrelated	same_domain	v
κατασκευάζω/λαμβάνω	unrelated	unrelated	v
κατασκευάζω/ἀναιρέω	related	unrelated	v
κατασκευάζω/παραδίδωμι	unrelated	unrelated	v
κατασκευάζω/παρέχω	synonym	unrelated	v
ἀποκρίνω/ἐρωτάω	related	distantly_related	v
ἀποκρίνω/λέγω	related	distantly_related	v
ἀποκρίνω/δοκέω	same_domain	same_domain	v
ἀποκρίνω/οἴομαι	same_domain	distantly_related	v
ἀποκρίνω/φημί	related	distantly_related	v
ἀποκρίνω/ἐλέγχω	related	same_domain	v
ἀποκρίνω/τολμάω	unrelated	unrelated	v
ἀποκρίνω/βούλομαι	unrelated	unrelated	v
ἀποκρίνω/πειράω	unrelated	unrelated	v
ἀποκρίνω/ἀγνοέω	same_domain	same_domain	v
ἀποκρίνω/ἀποφαίνω	related	related	v
ἀποκρίνω/γιγνώσκω	same_domain	same_domain	v
ἀποκρίνω/διαλέγω	related	distantly_related	v
ἀποκρίνω/ἀπαγγέλλω	related	related	v
ἀποκρίνω/συγχωρέω	same_domain	same_domain	v
ἀποκρίνω/φάσκω	related	distantly_related	v
ἀποκρίνω/πείθω	same_domain	unrelated	v
ἀποκρίνω/κελεύω	same_domain	unrelated	v
ἀποκρίνω/ἀξιόω	related	distantly_related	v
ἀποκρίνω/διδάσκω	related	distantly_related	v
ἀποκρίνω/ἀκούω	same_domain	same_domain	v
ἀποκρίνω/θαυμάζω	unrelated	same_domain	v
ἀποκρίνω/οἶδα	same_domain	same_domain	v
τέμνω/διαιρέω	related	related	v
τέμνω/ἐπιζεύγνυμι	distantly_related	distantly_related	v
τέμνω/περιέχω	unrelated	distantly_related	v
τέμνω/φέρω	unrelated	unrelated	v
τέμνω/φύω	unrelated	unrelated	v
τέμνω/βάλλω	unrelated	unrelated	v
τέμνω/ἀποτέμνω	synonym	synonym	v
τέμνω/σχίζω	related	synonym	v
τέμνω/κεῖμαι	unrelated	unrelated	v
τέμνω/τείνω	unrelated	same_domain	v
τέμνω/ἕλκω	unrelated	unrelated	v
τέμνω/ἄγω	unrelated	same_domain	v
τέμνω/ἀφαιρέω	related	unrelated	v
τέμνω/ἐκτείνω	unrelated	same_domain	v
τέμνω/ἐκβάλλω	unrelated	unrelated	v
τέμνω/νοέω	unrelated	distantly_related	v
συντίθημι/σύγκειμαι	synonym	distantly_related	v
συντίθημι/εὑρίσκω	unrelated	unrelated	v
συντίθημι/προστίθημι	synonym	synonym	v
συντίθημι/μίγνυμι	related	related	v
συντίθημι/διαιρέω	related	same_domain	v
συντίθημι/χράομαι	unrelated	same_domain	v
συντίθημι/τουτέστι	unrelated	unrelated	v
συντίθημι/ποιέω	related	related	v
συντίθημι/πολλαπλασιάζω	related	distantly_related	v
συντίθημι/ἀφαιρέω	related	same_domain	v
συντίθημι/γράφω	unrelated	synonym	v
συντίθημι/συνίστημι	synonym	synonym	v
συντίθημι/ἀποτελέω	unrelated	distantly_related	v
συντίθημι/παραλαμβάνω	unrelated	unrelated	v
συντίθημι/φυλάσσω	unrelated	unrelated	v
συντίθημι/παραδίδωμι	unrelated	distantly_related	v
συντίθημι/λαμβάνω	unrelated	distantly_related	v
συντίθημι/τίθημι	related	related	v
οἴχομαι/φεύγω	related	related	v
οἴχομαι/θνήσκω	related	distantly_related	v
οἴχομαι/ἄπειμι	synonym	synonym	v
οἴχομαι/ἔρχομαι	related	related	v
οἴχομαι/εἶμι	related	synonym	v
οἴχομαι/ὄλλυμι	related	distantly_related	v
οἴχομαι/κελεύω	unrelated	unrelated	v
οἴχομαι/δείδω	unrelated	unrelated	v
οἴχομαι/ἀπόλλυμι	related	distantly_related	v
οἴχομαι/κομίζω	unrelated	unrelated	v
οἴχομαι/ὁρμάω	related	distantly_related	v
οἴχομαι/ἀπέρχομαι	synonym	synonym	v
οἴχομαι/ἥκω	related	distantly_related	v
οἴχομαι/διαφθείρω	related	distantly_related	v
οἴχομαι/ἀφικνέομαι	related	related	v
οἴχομαι/ἐάω	unrelated	same_domain	v
οἴχομαι/ἀφίημι	distantly_related	distantly_related	v
οἴχομαι/χωρέω	related	synonym	v
οἴχομαι/ἀναχωρέω	related	synonym	v
οἴχομαι/λανθάνω	related	distantly_related	v
γαμέω/συνοικέω	related	related	v
γαμέω/τελευτάω	unrelated	same_domain	v
γαμέω/θνήσκω	unrelated	same_domain	v
γαμέω/σύνειμι	related	related	v
γαμέω/πείθω	unrelated	unrelated	v
γαμέω/ἐθέλω	unrelated	unrelated	v
γαμέω/ἐράω	related	distantly_related	v
γαμέω/ἀποθνήσκω	unrelated	same_domain	v
γαμέω/μέλλω	unrelated	unrelated	v
γαμέω/παιδοποιέω	same_domain	distantly_related	v
γαμέω/τίκτω	same_domain	distantly_related	v
γαμέω/ἐκδίδωμι	synonym	unrelated	v
γαμέω/ἁρπάζω	unrelated	unrelated	v
γαμέω/ἄγω	synonym	same_domain	v
γαμέω/συνοικίζω	synonym	related	v
γαμέω/τιμάω	distantly_related	same_domain	v
γαμέω/βασιλεύω	unrelated	unrelated	v
γαμέω/μνηστεύω	related	related	v
γαμέω/πράσσω	unrelated	unrelated	v
γαμέω/ἀποκτείνω	unrelated	unrelated	v
γαμέω/φεύγω	unrelated	unrelated	v
γαμέω/γεννάω	same_domain	distantly_related	v
βιάζω/ἀναγκάζω	synonym	synonym	v
βιάζω/κρατέω	synonym	distantly_related	v
βιάζω/φεύγω	same_domain	distantly_related	v
βιάζω/τολμάω	same_domain	same_domain	v
βιάζω/πείθω	same_domain	same_domain	v
βιάζω/ἐπιχειρέω	distantly_related	same_domain	v
βιάζω/κωλύω	synonym	distantly_related	v
βιάζω/κελεύω	distantly_related	same_domain	v
βιάζω/πειράω	distantly_related	same_domain	v
βιάζω/βούλομαι	unrelated	unrelated	v
βιάζω/διαφθείρω	same_domain	distantly_related	v
βιάζω/ὁρμάω	distantly_related	distantly_related	v
βιάζω/ἐάω	related	unrelated	v
βιάζω/δείδω	same_domain	same_domain	v
βιάζω/κατέχω	synonym	distantly_related	v
βιάζω/ὠθέω	related	distantly_related	v
βιάζω/ἐπιτρέπω	unrelated	same_domain	v
βιάζω/ἀμύνω	related	distantly_related	v
βιάζω/διώκω	same_domain	distantly_related	v
βιάζω/νικάω	same_domain	related	v
φιλέω/μισέω	related	distantly_related	v
φιλέω/ἀγαπάω	synonym	related	v
φιλέω/τιμάω	distantly_related	related	v
φιλέω/ἐράω	synonym	synonym	v
φιλέω/ἐθέλω	same_domain	same_domain	v
φιλέω/πείθω	unrelated	unrelated	v
φιλέω/ἐπαινέω	same_domain	distantly_related	v
φιλέω/τέρπω	related	related	v
φιλέω/ἥδομαι	distantly_related	related	v
φιλέω/ἀείδω	same_domain	same_domain	v
φιλέω/ἀσπάζομαι	synonym	related	v
φιλέω/θαυμάζω	distantly_related	related	v
φιλέω/στέργω	synonym	synonym	v
φιλέω/ποθέω	related	distantly_related	v
φιλέω/οἶδα	unrelated	same_domain	v
φιλέω/νομίζω	unrelated	unrelated	v
φιλέω/λυπέω	same_domain	distantly_related	v
φιλέω/γιγνώσκω	unrelated	related	v
χαρίζω/πείθω	unrelated	same_domain	v
χαρίζω/αἰτέω	distantly_related	same_domain	v
χαρίζω/παρακαλέω	same_domain	distantly_related	v
χαρίζω/βούλομαι	unrelated	same_domain	v
χαρίζω/ἐπαινέω	related	distantly_related	v
χαρίζω/κτάομαι	same_domain	same_domain	v
χαρίζω/ἀδικέω	distantly_related	same_domain	v
χαρίζω/πρέπω	unrelated	unrelated	v
χαρίζω/προσήκω	unrelated	unrelated	v
χαρίζω/νομίζω	unrelated	same_domain	v
χαρίζω/παρέχω	related	related	v
χαρίζω/τιμάω	related	related	v
χαρίζω/ἀξιόω	same_domain	related	v
χαρίζω/ἀπολαύω	distantly_related	synonym	v
χαρίζω/τυγχάνω	distantly_related	unrelated	v
χαρίζω/δωρέω	synonym	synonym	v
χαρίζω/πράσσω	distantly_related	same_domain	v
χαρίζω/φροντίζω	distantly_related	same_domain	v
χαρίζω/δίδωμι	related	synonym	v
χαρίζω/ποιέω	distantly_related	same_domain	v
χαρίζω/χράομαι	same_domain	same_domain	v
χαρίζω/βοηθέω	related	distantly_related	v
χαρίζω/πιστεύω	unrelated	distantly_related	v
ἀποστερέω/ἀδικέω	same_domain	distantly_related	v
ἀποστερέω/νομίζω	unrelated	unrelated	v
ἀποστερέω/προδίδωμι	distantly_related	unrelated	v
ἀποστερέω/ὑβρίζω	same_domain	related	v
ἀποστερέω/τιμάω	unrelated	distantly_related	v
ἀποστερέω/ἀπολαύω	unrelated	same_domain	v
ἀποστερέω/κτάομαι	related	related	v
ἀποστερέω/στερέω	synonym	synonym	v
ἀποστερέω/πράσσω	unrelated	unrelated	v
ἀποστερέω/συκοφαντέω	same_domain	distantly_related	v
ἀποστερέω/ἀφαιρέω	synonym	synonym	v
ἀποστερέω/τολμάω	unrelated	same_domain	v
ἀποστερέω/ἀπόλλυμι	related	distantly_related	v
ἀποστερέω/παρέχω	related	same_domain	v
ἀποστερέω/διαφθείρω	same_domain	distantly_related	v
ἀποστερέω/ἀποκτείνω	same_domain	distantly_related	v
ἀποστερέω/τυγχάνω	related	unrelated	v
ἀποστερέω/μετέχω	distantly_related	unrelated	v
ἀποστερέω/καταφρονέω	unrelated	same_domain	v
ἀποστερέω/ζημιόω	same_domain	distantly_related	v
δανείζω/ἀποδίδωμι	related	distantly_related	v
δανείζω/ὁμολογέω	unrelated	same_domain	v
δανείζω/ὀφείλω	related	distantly_related	v
δανείζω/προγράφω	same_domain	unrelated	v
δανείζω/πρόκειμαι	unrelated	unrelated	v
δανείζω/μισθόω	related	distantly_related	v
δανείζω/κεφαλαιόω	unrelated	unrelated	v
δανείζω/χρεωστέω	related	related	v
δανείζω/ἐκτίνω	related	distantly_related	v
δανείζω/βεβαιόω	same_domain	unrelated	v
δανείζω/ἀποτίνω	related	distantly_related	v
δανείζω/πιπράσκω	distantly_related	same_domain	v
δανείζω/ἐνεγγυάω	related	same_domain	v
δανείζω/πρίαμαι	distantly_related	same_domain	v
δανείζω/ἀπέχω	distantly_related	same_domain	v
δανείζω/δίδωμι	related	distantly_related	v
δανείζω/ἐπιδίδωμι	related	distantly_related	v
φορέω/βάλλω	distantly_related	unrelated	v
φορέω/φέρω	synonym	synonym	v
φορέω/πέλω	unrelated	unrelated	v
φορέω/ῥίπτω	distantly_related	same_domain	v
φορέω/ἀείρω	distantly_related	unrelated	v
φορέω/βαίνω	unrelated	same_domain	v
φορέω/τεύχω	unrelated	unrelated	v
φορέω/ἑλίσσω	distantly_related	unrelated	v
φορέω/ἵστημι	unrelated	unrelated	v
φορέω/καλύπτω	related	unrelated	v
φορέω/περιτίθημι	related	unrelated	v
φορέω/περιβάλλω	related	distantly_related	v
φορέω/ὄλλυμι	unrelated	unrelated	v
φορέω/ἕλκω	related	distantly_related	v
φορέω/ἐνδύω	related	distantly_related	v
φορέω/ἐρύω	distantly_related	distantly_related	v
φορέω/ἐρείδω	unrelated	unrelated	v
φορέω/ἐλαύνω	same_domain	unrelated	v
ἀείρω/βάλλω	distantly_related	unrelated	v
ἀείρω/μάρναμαι	unrelated	same_domain	v
ἀείρω/κορύσσω	unrelated	same_domain	v
ἀείρω/βαίνω	unrelated	same_domain	v
ἀείρω/πέλω	unrelated	unrelated	v
ἀείρω/ἐρύω	related	same_domain	v
ἀείρω/τεύχω	unrelated	same_domain	v
ἀείρω/ἑλίσσω	distantly_related	same_domain	v
ἀείρω/ὄλλυμι	distantly_related	synonym	v
ἀείρω/τιταίνω	distantly_related	same_domain	v
ἀείρω/τινάσσω	distantly_related	distantly_related	v
ἀείρω/κουφίζω	synonym	unrelated	v
ἀείρω/ἐρείδω	related	related	v
ἀείρω/φέρω	related	synonym	v
ἀείρω/ἱκνέομαι	unrelated	unrelated	v
ἀείρω/ἵστημι	related	synonym	v
ἀείρω/φορέω	distantly_related	related	v
ἀείρω/ἐλαύνω	unrelated	same_domain	v
ἀείρω/ἕλκω	related	same_domain	v
ἀείρω/ἐλαφρίζω	synonym	distantly_related	v
ἀείρω/ῥίπτω	distantly_related	unrelated	v
ἀποτίθημι/ἀναλαμβάνω	related	related	v
ἀποτίθημι/ἐπιτίθημι	related	distantly_related	v
ἀποτίθημι/ἐνδύω	unrelated	unrelated	v
ἀποτίθημι/περιτίθημι	related	distantly_related	v
ἀποτίθημι/κομίζω	distantly_related	same_domain	v
ἀποτίθημι/κελεύω	unrelated	unrelated	v
ἀποτίθημι/ἀφαιρέω	related	related	v
ἀποτίθημι/αἴρω	related	related	v
ἀποτίθημι/περιβάλλω	unrelated	unrelated	v
ἀποτίθημι/φέρω	distantly_related	same_domain	v
ἀποτίθημι/κατατίθημι	synonym	related	v
ἀποτίθημι/κατέχω	distantly_related	unrelated	v
ἀποτίθημι/ἐμβάλλω	distantly_related	same_domain	v
ἀποτίθημι/περιαιρέω	synonym	distantly_related	v
ἀποτίθημι/τίθημι	related	distantly_related	v
ἀποτίθημι/ἀφίημι	synonym	distantly_related	v
ἀποτίθημι/χράομαι	unrelated	unrelated	v
ἀποτίθημι/καθίστημι	distantly_related	synonym	v
ἀποτίθημι/ἄγω	distantly_related	unrelated	v
μετέρχομαι/μέτειμι	synonym	synonym	v
μετέρχομαι/κτείνω	distantly_related	same_domain	v
μετέρχομαι/σπεύδω	synonym	distantly_related	v
μετέρχομαι/ἐθέλω	unrelated	unrelated	v
μετέρχομαι/ἀμύνω	same_domain	same_domain	v
μετέρχομαι/νομίζω	unrelated	unrelated	v
μετέρχομαι/δείδω	unrelated	unrelated	v
μετέρχομαι/πείθω	unrelated	unrelated	v
μετέρχομαι/θνήσκω	unrelated	unrelated	v
μετέρχομαι/ἡγέομαι	distantly_related	distantly_related	v
μετέρχομαι/μεταβαίνω	synonym	distantly_related	v
μετέρχομαι/τρέπω	distantly_related	related	v
μετέρχομαι/τιμωρέω	synonym	synonym	v
μετέρχομαι/παραδίδωμι	unrelated	unrelated	v
μετέρχομαι/ἐπαινέω	unrelated	same_domain	v
μετέρχομαι/κολάζω	unrelated	related	v
μετέρχομαι/χράω	unrelated	unrelated	v
μετέρχομαι/μεθίστημι	synonym	unrelated	v
μετέρχομαι/ἀφίστημι	distantly_related	unrelated	v
μετέρχομαι/ἐπάγω	distantly_related	unrelated	v
μετέρχομαι/ἀξιόω	synonym	unrelated	v
μετέρχομαι/τίθημι	unrelated	unrelated	v
μετέρχομαι/ἄγω	same_domain	unrelated	v
μετέρχομαι/ἀναιρέω	unrelated	unrelated	v
μετέρχομαι/καθίστημι	same_domain	unrelated	v
μετέρχομαι/ἥκω	distantly_related	distantly_related	v
μετέρχομαι/ἔρχομαι	related	related	v
μετέρχομαι/ποιέω	unrelated	same_domain	v
μετέρχομαι/ἀποφαίνω	distantly_related	unrelated	v
μετέρχομαι/ἀποδείκνυμι	distantly_related	unrelated	v
ἀποτίνω/ἐκτίνω	synonym	synonym	v
ἀποτίνω/ἀποδίδωμι	synonym	synonym	v
ἀποτίνω/προγράφω	same_domain	unrelated	v
ἀποτίνω/ὀφείλω	distantly_related	distantly_related	v
ἀποτίνω/πρόκειμαι	unrelated	same_domain	v
ἀποτίνω/δανείζω	related	distantly_related	v
ἀποτίνω/εἰσπράσσω	related	unrelated	v
ἀποτίνω/μισθόω	distantly_related	distantly_related	v
ἀποτίνω/πρίαμαι	related	distantly_related	v
ἀποτίνω/ἀπαιτέω	related	same_domain	v
ἀποτίνω/βεβαιόω	same_domain	distantly_related	v
ἀποτίνω/πιπράσκω	related	distantly_related	v
ἀποτίνω/ἀπέχω	related	unrelated	v
ἀποτίνω/προσοφείλω	distantly_related	distantly_related	v
ἀποτίνω/ὁμολογέω	unrelated	same_domain	v
ἀποτίνω/παρέχω	related	related	v
ἀποτίνω/δίδωμι	related	related	v
ἀποτίνω/παραδίδωμι	related	related	v
περιαιρέω/περιτίθημι	related	same_domain	v
περιαιρέω/περίκειμαι	distantly_related	same_domain	v
περιαιρέω/ἀποτίθημι	synonym	related	v
περιαιρέω/περιβάλλω	related	same_domain	v
περιαιρέω/ἀφαιρέω	synonym	related	v
περιαιρέω/ἐπιτίθημι	related	same_domain	v
περιαιρέω/ἐνδύω	distantly_related	unrelated	v
περιαιρέω/καλύπτω	related	same_domain	v
περιαιρέω/φέρω	distantly_related	distantly_related	v
περιαιρέω/φορέω	same_domain	distantly_related	v
περιαιρέω/αἴρω	synonym	distantly_related	v
περιαιρέω/κοσμέω	same_domain	unrelated	v
περιαιρέω/ἐμβάλλω	distantly_related	same_domain	v
περιαιρέω/ἀναλαμβάνω	related	related	v
περιαιρέω/ἀφίημι	related	distantly_related	v
περιαιρέω/λαμβάνω	distantly_related	related	v
περιαιρέω/ἀναιρέω	synonym	related	v
ἀπελαύνω/ἐξελαύνω	synonym	synonym	v
ἀπελαύνω/ἐλαύνω	synonym	synonym	v
ἀπελαύνω/φεύγω	related	synonym	v
ἀπελαύνω/καθίστημι	unrelated	distantly_related	v
ἀπελαύνω/κελεύω	unrelated	same_domain	v
ἀπελαύνω/ἀπάγω	synonym	related	v
ἀπελαύνω/διώκω	distantly_related	related	v
ἀπελαύνω/κατέχω	distantly_related	same_domain	v
ἀπελαύνω/διαφθείρω	same_domain	related	v
ἀπελαύνω/ἄπειμι	related	distantly_related	v
ἀπελαύνω/ἀπέρχομαι	related	distantly_related	v
ἀπελαύνω/ἄγω	distantly_related	distantly_related	v
ἀπελαύνω/ἐκπέμπω	related	synonym	v
ἀπελαύνω/ἀποπέμπω	related	synonym	v
ἀπελαύνω/ἀναγκάζω	same_domain	related	v
ἀπελαύνω/ἀποκτείνω	same_domain	distantly_related	v
ἀπελαύνω/πέμπω	distantly_related	related	v
ἀπελαύνω/ἐκβάλλω	synonym	synonym	v
ἀπελαύνω/οἴχομαι	distantly_related	distantly_related	v
ἀπελαύνω/ἥκω	distantly_related	same_domain	v
ἀπελαύνω/ἀναχωρέω	related	distantly_related	v
εὐδαιμονέω/ζάω	distantly_related	related	v
εὐδαιμονέω/πλουτέω	synonym	related	v
εὐδαιμονέω/πράσσω	related	unrelated	v
εὐδαιμονέω/εὐτυχέω	synonym	synonym	v
εὐδαιμονέω/φιλοσοφέω	unrelated	distantly_related	v
εὐδαιμονέω/κακοδαιμονέω	related	distantly_related	v
εὐδαιμονέω/δυστυχέω	related	distantly_related	v
εὐδαιμονέω/σωφρονέω	distantly_related	related	v
εὐδαιμονέω/οἴομαι	unrelated	unrelated	v
εὐδαιμονέω/ἀπολαύω	distantly_related	synonym	v
εὐδαιμονέω/ὑγιαίνω	related	synonym	v
εὐδαιμονέω/βιόω	distantly_related	related	v
εὐδαιμονέω/κτάομαι	same_domain	unrelated	v
εὐδαιμονέω/ἀτυχέω	related	distantly_related	v
εὐδαιμονέω/διατελέω	distantly_related	unrelated	v
εὐδαιμονέω/πολιτεύω	unrelated	same_domain	v
εὐδαιμονέω/ὠφελέω	related	unrelated	v
εὐδαιμονέω/διάγω	distantly_related	distantly_related	v
εὐδαιμονέω/σώζω	distantly_related	unrelated	v
εὐδαιμονέω/λυπέω	related	same_domain	v
εὐδαιμονέω/κερδαίνω	related	same_domain	v
εὐδαιμονέω/γιγνώσκω	unrelated	unrelated	v
ἀνασκευάζω/ἀντιστρέφω	related	same_domain	v
ἀνασκευάζω/δείκνυμι	same_domain	unrelated	v
ἀνασκευάζω/ἐνδέχομαι	unrelated	distantly_related	v
ἀνασκευάζω/συλλογίζομαι	same_domain	unrelated	v
ἀνασκευάζω/κατασκευάζω	related	related	v
ἀνασκευάζω/δεικνύω	same_domain	unrelated	v
ἀνασκευάζω/ἀντίκειμαι	distantly_related	unrelated	v
ἀνασκευάζω/ἀληθεύω	unrelated	same_domain	v
ἀνασκευάζω/συμπεραίνω	same_domain	unrelated	v
ἀνασκευάζω/κατηγορέω	same_domain	synonym	v
ἀνασκευάζω/ἀναιρέω	synonym	synonym	v
ἀνασκευάζω/συνάγω	unrelated	synonym	v
ἀνασκευάζω/ἐκτίθημι	distantly_related	same_domain	v
ἀνασκευάζω/συναληθεύω	unrelated	unrelated	v
ἀνασκευάζω/ἀποδείκνυμι	same_domain	unrelated	v
ἀνασκευάζω/μεταλαμβάνω	unrelated	related	v
ἀνασκευάζω/λαμβάνω	distantly_related	related	v
εὐθύνω/ὑπέχω	same_domain	related	v
εὐθύνω/ἐξετάζω	synonym	synonym	v
εὐθύνω/καταψηφίζομαι	same_domain	related	v
εὐθύνω/ἐλέγχω	synonym	synonym	v
εὐθύνω/ἀφίημι	unrelated	unrelated	v
εὐθύνω/ἰθύνω	synonym	synonym	v
εὐθύνω/ἐξελέγχω	synonym	related	v
εὐθύνω/κολάζω	same_domain	related	v
εὐθύνω/διαστρέφω	unrelated	related	v
εὐθύνω/δικάζω	same_domain	synonym	v
εὐθύνω/παραδίδωμι	unrelated	unrelated	v
εὐθύνω/κυβερνάω	synonym	synonym	v
εὐθύνω/χράομαι	unrelated	unrelated	v
εὐθύνω/ἐπιτιμάω	same_domain	synonym	v
εὐθύνω/αἰτιάομαι	same_domain	synonym	v
εὐθύνω/ἐπιχειρέω	unrelated	unrelated	v
εὐθύνω/κρίνω	related	synonym	v
εὐθύνω/ἀναγκάζω	unrelated	same_domain	v
εὐθύνω/ἀντεῖπον	unrelated	distantly_related	v
εὐθύνω/ἐπαινέω	unrelated	distantly_related	v
εὐθύνω/ἀναιρέω	unrelated	unrelated	v
εὐθύνω/ἀποφαίνω	unrelated	synonym	v
εὐθύνω/ποιέω	unrelated	same_domain	v
εὐθύνω/εὑρίσκω	unrelated	unrelated	v
εὐθύνω/δίδωμι	unrelated	unrelated	v
εὐθύνω/τιμωρέω	unrelated	related	v
εὐθύνω/ἄγω	related	unrelated	v
εὐθύνω/ἀποδείκνυμι	unrelated	unrelated	v
εὐθύνω/διαλέγω	unrelated	unrelated	v
εὐθύνω/δείκνυμι	unrelated	same_domain	v
κρούω/πλήσσω	synonym	synonym	v
κρούω/τύπτω	synonym	synonym	v
κρούω/ὀρχέομαι	same_domain	synonym	v
κρούω/παίω	synonym	synonym	v
κρούω/κροτέω	synonym	related	v
κρούω/φθέγγομαι	distantly_related	distantly_related	v
κρούω/ψοφέω	distantly_related	distantly_related	v
κρούω/ἀράσσω	synonym	synonym	v
κρούω/ὠθέω	related	distantly_related	v
κρούω/ἀείδω	distantly_related	distantly_related	v
κρούω/ψάλλω	related	synonym	v
κρούω/ἠχέω	distantly_related	distantly_related	v
κρούω/αὐλέω	distantly_related	same_domain	v
κρούω/τείνω	same_domain	distantly_related	v
κρούω/κιθαρίζω	distantly_related	related	v
κρούω/σείω	distantly_related	distantly_related	v
κρούω/ἐρείδω	related	synonym	v
κρούω/βάλλω	unrelated	unrelated	v
κρούω/ἵστημι	unrelated	unrelated	v
κρούω/συντρίβω	related	distantly_related	v
κρούω/ἀφίημι	unrelated	unrelated	v
κρούω/δείδω	unrelated	unrelated	v
κρούω/πατάσσω	synonym	synonym	v
ληίζομαι/λεηλατέω	synonym	synonym	v
ληίζομαι/πορθέω	synonym	related	v
ληίζομαι/κατατρέχω	related	related	v
ληίζομαι/δηιόω	related	related	v
ληίζομαι/πολιορκέω	same_domain	related	v
ληίζομαι/διαρπάζω	synonym	related	v
ληίζομαι/καταλαμβάνω	related	synonym	v
ληίζομαι/αἱρέω	related	synonym	v
ληίζομαι/διαβαίνω	unrelated	unrelated	v
ληίζομαι/καταστρέφω	same_domain	related	v
ληίζομαι/ἐμπίμπρημι	same_domain	distantly_related	v
ληίζομαι/ὁρμάω	same_domain	distantly_related	v
ληίζομαι/χειρόω	related	distantly_related	v
ληίζομαι/ἀναχωρέω	unrelated	unrelated	v
ληίζομαι/κατέχω	same_domain	synonym	v
ληίζομαι/ἐξελαύνω	related	distantly_related	v
ληίζομαι/πολεμέω	same_domain	distantly_related	v
σκεπάζω/περιβάλλω	related	related	v
σκεπάζω/γυμνόω	related	distantly_related	v
σκεπάζω/σκέπω	synonym	synonym	v
σκεπάζω/καλύπτω	synonym	synonym	v
σκεπάζω/ἐπιτίθημι	related	distantly_related	v
σκεπάζω/σχίζω	unrelated	unrelated	v
σκεπάζω/βάλλω	distantly_related	unrelated	v
σκεπάζω/ἐντίθημι	distantly_related	distantly_related	v
σκεπάζω/καθίημι	unrelated	unrelated	v
σκεπάζω/ζώννυμι	distantly_related	same_domain	v
σκεπάζω/κατακρύπτω	synonym	related	v
σκεπάζω/ἐνδύω	distantly_related	related	v
σκεπάζω/κρύπτω	synonym	related	v
σκεπάζω/ἀποτέμνω	unrelated	unrelated	v
σκεπάζω/ἐπιβάλλω	related	distantly_related	v
σκεπάζω/περιτίθημι	related	related	v
σκεπάζω/ἐπίκειμαι	related	same_domain	v
σκεπάζω/τιτρώσκω	same_domain	unrelated	v
σκεπάζω/φυλάσσω	related	related	v
σκεπάζω/ψαύω	unrelated	unrelated	v
σκεπάζω/περικαλύπτω	synonym	related	v
σκεπάζω/θλίβω	unrelated	unrelated	v
σκεπάζω/εἰσέρχομαι	unrelated	unrelated	v
σκεπάζω/ἐμπλάσσω	unrelated	unrelated	v
κατακρύπτω/κρύπτω	synonym	synonym	v
κατακρύπτω/βάλλω	unrelated	unrelated	v
κατακρύπτω/καλύπτω	synonym	related	v
κατακρύπτω/καταδύω	distantly_related	unrelated	v
κατακρύπτω/ἐκφύω	unrelated	unrelated	v
κατακρύπτω/ψαύω	unrelated	unrelated	v
κατακρύπτω/ἕλκω	unrelated	unrelated	v
κατακρύπτω/τιτρώσκω	unrelated	unrelated	v
κατακρύπτω/περίκειμαι	unrelated	unrelated	v
κατακρύπτω/ῥίπτω	unrelated	unrelated	v
κατακρύπτω/καταφέρω	unrelated	distantly_related	v
κατακρύπτω/ἐπίκειμαι	distantly_related	same_domain	v
κατακρύπτω/ἐμφύω	unrelated	unrelated	v
κατακρύπτω/ἀποκρύπτω	synonym	synonym	v
κατακρύπτω/περιβάλλω	distantly_related	distantly_related	v
κατακρύπτω/φυλάσσω	same_domain	unrelated	v
κατακρύπτω/κατέχω	distantly_related	unrelated	v
κατακρύπτω/καθίημι	unrelated	unrelated	v
κατακρύπτω/ἐμβάλλω	unrelated	distantly_related	v
κατακρύπτω/ἐπιτίθημι	distantly_related	distantly_related	v
κατακρύπτω/κατορύσσω	distantly_related	distantly_related	v
κατακρύπτω/καταλαμβάνω	distantly_related	unrelated	v
κατακρύπτω/ἀποφύω	unrelated	unrelated	v
κατακρύπτω/κατακλείω	unrelated	related	v
κατακρύπτω/θάπτω	distantly_related	distantly_related	v
ποιμαίνω/νέμω	synonym	synonym	v
ποιμαίνω/βόσκω	synonym	synonym	v
ποιμαίνω/πιαίνω	synonym	related	v
ποιμαίνω/ἁρπάζω	unrelated	unrelated	v
ποιμαίνω/διασκορπίζω	unrelated	same_domain	v
ποιμαίνω/ἐξελαύνω	distantly_related	related	v
ποιμαίνω/πορεύομαι	distantly_related	related	v
ποιμαίνω/καθηγέομαι	synonym	related	v
ποιμαίνω/ὁδηγέω	synonym	related	v
ποιμαίνω/διατρέφω	same_domain	related	v
ποιμαίνω/κατοικέω	unrelated	same_domain	v
ποιμαίνω/παροικέω	unrelated	same_domain	v
ποιμαίνω/ἀποστέλλω	unrelated	related	v
ποιμαίνω/κατανέμω	synonym	synonym	v
ποιμαίνω/κληρονομέω	unrelated	unrelated	v
ποιμαίνω/εὐλογέω	unrelated	unrelated	v
ποιμαίνω/καταβαίνω	distantly_related	distantly_related	v
ποιμαίνω/ἐξέρχομαι	distantly_related	distantly_related	v
ποιμαίνω/προσκυνέω	unrelated	unrelated	v
ποιμαίνω/πατάσσω	unrelated	unrelated	v
ποιμαίνω/ἔρχομαι	distantly_related	distantly_related	v
ποιμαίνω/προφητεύω	unrelated	unrelated	v
ποιμαίνω/ἀναβαίνω	distantly_related	distantly_related	v
ποιμαίνω/ἄγω	related	related	v
ποιμαίνω/εἰσέρχομαι	distantly_related	distantly_related	v
ποιμαίνω/δουλεύω	unrelated	unrelated	v
ἀναδείκνυμι/καθίστημι	distantly_related	synonym	v
ἀναδείκνυμι/ἀναγορεύω	synonym	synonym	v
ἀναδείκνυμι/τιμάω	related	related	v
ἀναδείκνυμι/χειροτονέω	distantly_related	related	v
ἀναδείκνυμι/κοσμέω	distantly_related	related	v
ἀναδείκνυμι/ψηφίζω	same_domain	related	v
ἀναδείκνυμι/ἀποδείκνυμι	synonym	synonym	v
ἀναδείκνυμι/βασιλεύω	unrelated	same_domain	v
ἀναδείκνυμι/προστάσσω	unrelated	synonym	v
ἀναδείκνυμι/προίστημι	related	synonym	v
ἀναδείκνυμι/παραδίδωμι	unrelated	related	v
ἀναδείκνυμι/ἐκπέμπω	unrelated	unrelated	v
ἀναδείκνυμι/ἐπιτρέπω	unrelated	unrelated	v
ἀναδείκνυμι/καταλείπω	unrelated	unrelated	v
ἀναδείκνυμι/ἀποστέλλω	unrelated	unrelated	v
ἀναδείκνυμι/πέμπω	unrelated	unrelated	v
ἀναδείκνυμι/εἰσάγω	unrelated	related	v
ἀναδείκνυμι/ἀποφαίνω	synonym	synonym	v
ἀναδείκνυμι/ποιέω	distantly_related	synonym	v
δεξιόομαι/ἀσπάζομαι	synonym	synonym	v
δεξιόομαι/προπέμπω	unrelated	unrelated	v
δεξιόομαι/φιλοφρονέομαι	synonym	related	v
δεξιόομαι/τιμάω	distantly_related	related	v
δεξιόομαι/προσκυνέω	synonym	related	v
δεξιόομαι/κελεύω	unrelated	unrelated	v
δεξιόομαι/ἄπειμι	unrelated	unrelated	v
δεξιόομαι/προστρέχω	unrelated	related	v
δεξιόομαι/αἰτέω	unrelated	unrelated	v
δεξιόομαι/ἑστιάω	distantly_related	related	v
δεξιόομαι/παρακαλέω	same_domain	same_domain	v
δεξιόομαι/δωρέω	same_domain	distantly_related	v
δεξιόομαι/δέχομαι	related	same_domain	v
δεξιόομαι/καταφιλέω	related	related	v
δεξιόομαι/πυνθάνομαι	unrelated	unrelated	v
δεξιόομαι/πέμπω	same_domain	unrelated	v
δεξιόομαι/θεραπεύω	same_domain	unrelated	v
δεξιόομαι/ἄγω	unrelated	unrelated	v
ἐναπολαμβάνω/ἐκθλίβω	distantly_related	related	v
ἐναπολαμβάνω/πυκνόω	synonym	related	v
ἐναπολαμβάνω/πιλέω	related	related	v
ἐναπολαμβάνω/ψοφέω	unrelated	unrelated	v
ἐναπολαμβάνω/ἐκκρίνω	distantly_related	related	v
ἐναπολαμβάνω/συμπιλέω	related	related	v
ἐναπολαμβάνω/ὠθέω	distantly_related	distantly_related	v
ἐναπολαμβάνω/συνωθέω	related	related	v
ἐναπολαμβάνω/ἀντιπεριίστημι	related	distantly_related	v
ἐναπολαμβάνω/ἀποπάλλω	unrelated	unrelated	v
ἐναπολαμβάνω/ἐκπυρόω	same_domain	unrelated	v
ἐναπολαμβάνω/θερμαίνω	same_domain	same_domain	v
ἐναπολαμβάνω/ἀραιόω	same_domain	unrelated	v
ἐναπολαμβάνω/διηχέω	unrelated	unrelated	v
ἐναπολαμβάνω/στενοχωρέω	synonym	unrelated	v
ἐναπολαμβάνω/ἐκπνέω	related	unrelated	v
ἐναπολαμβάνω/ἐνυπάρχω	related	distantly_related	v
ἐναπολαμβάνω/ἀναθυμιάω	related	unrelated	v
ἐναπολαμβάνω/περιέχω	distantly_related	synonym	v
ἐναπολαμβάνω/παρασπείρω	unrelated	unrelated	v
ἐναπολαμβάνω/κινέω	unrelated	unrelated	v
ἐναπολαμβάνω/ἐξατμίζω	related	unrelated	v
ἐναπολαμβάνω/συνίστημι	related	related	v
ἐναπολαμβάνω/ῥέω	same_domain	unrelated	v
ἐναπολαμβάνω/καταψύχω	same_domain	unrelated	v
ἐναπολαμβάνω/ἀντιμεθίστημι	unrelated	unrelated	v
ἐναπολαμβάνω/περιχέω	distantly_related	unrelated	v
ἐναπολαμβάνω/κυκλοφορέομαι	unrelated	unrelated	v
αὔω/ἐπισεύω	same_domain	unrelated	v
αὔω/ὄρνυμι	related	unrelated	v
αὔω/κέλομαι	synonym	same_domain	v
αὔω/κίω	unrelated	unrelated	v
αὔω/μάρναμαι	unrelated	unrelated	v
αὔω/ὄλλυμι	same_domain	unrelated	v
αὔω/ἰάχω	synonym	synonym	v
αὔω/ἄνωγα	distantly_related	distantly_related	v
αὔω/ἐπορούω	unrelated	unrelated	v
αὔω/μετεῖπον	distantly_related	related	v
αὔω/ἀίω	same_domain	unrelated	v
αὔω/ἕζομαι	unrelated	unrelated	v
αὔω/ἱκνέομαι	unrelated	unrelated	v
αὔω/ὀρούω	unrelated	unrelated	v
αὔω/λίσσομαι	distantly_related	same_domain	v
αὔω/ἅλλομαι	unrelated	same_domain	v
αὔω/θαμβέω	same_domain	same_domain	v
αὔω/στενάχω	related	related	v
αὔω/ἐκθρῴσκω	unrelated	unrelated	v
αὔω/κλάζω	synonym	unrelated	v
αὔω/ἐλεαίρω	same_domain	same_domain	v
αὔω/ἀυτέω	synonym	synonym	v
αὔω/ἵκω	unrelated	unrelated	v
προλείπω/ἱκνέομαι	distantly_related	distantly_related	v
προλείπω/ὄλλυμι	distantly_related	same_domain	v
προλείπω/πέλω	unrelated	unrelated	v
προλείπω/λείπω	synonym	related	v
προλείπω/ἔλπω	unrelated	unrelated	v
προλείπω/βλώσκω	distantly_related	distantly_related	v
προλείπω/τεύχω	distantly_related	same_domain	v
προλείπω/ἀέξω	unrelated	same_domain	v
προλείπω/θνήσκω	unrelated	distantly_related	v
προλείπω/ναίω	unrelated	unrelated	v
προλείπω/δαμάζω	unrelated	same_domain	v
προλείπω/νοσφίζω	synonym	related	v
προλείπω/μήδομαι	distantly_related	unrelated	v
προλείπω/ὀπάζω	unrelated	same_domain	v
προλείπω/εἰσοράω	distantly_related	unrelated	v
προλείπω/εὐνάζω	unrelated	same_domain	v
προλείπω/ἀμείβω	unrelated	same_domain	v
προλείπω/ἐγείρω	unrelated	same_domain	v
προλείπω/πελάζω	unrelated	same_domain	v
προλείπω/λιπάω	unrelated	unrelated	v
προλείπω/ἀνάσσω	unrelated	unrelated	v
προλείπω/ἐκλείπω	synonym	synonym	v
προλείπω/ἄγω	unrelated	unrelated	v
προλείπω/καταλείπω	synonym	synonym	v
ἐπιβοηθέω/πολιορκέω	same_domain	distantly_related	v
ἐπιβοηθέω/συμφεύγω	distantly_related	distantly_related	v
ἐπιβοηθέω/προσβάλλω	distantly_related	distantly_related	v
ἐπιβοηθέω/στρατοπεδεύω	same_domain	distantly_related	v
ἐπιβοηθέω/φεύγω	same_domain	same_domain	v
ἐπιβοηθέω/ἀναχωρέω	same_domain	same_domain	v
ἐπιβοηθέω/προσμάχομαι	distantly_related	distantly_related	v
ἐπιβοηθέω/προσβοηθέω	synonym	synonym	v
ἐπιβοηθέω/ἀμύνω	synonym	distantly_related	v
ἐπιβοηθέω/προσμείγνυμι	distantly_related	distantly_related	v
ἐπιβοηθέω/ὑπαντιάζω	related	related	v
ἐπιβοηθέω/ὁρμάω	distantly_related	same_domain	v
ἐπιβοηθέω/βοηθέω	synonym	synonym	v
ἐπιβοηθέω/ἐφεδρεύω	distantly_related	unrelated	v
ἐπιβοηθέω/καταφεύγω	same_domain	same_domain	v
ἐπιβοηθέω/ἀποτειχίζω	same_domain	same_domain	v
ἐπιβοηθέω/διαγωνίζομαι	distantly_related	distantly_related	v
ἐπιβοηθέω/ἀφικνέομαι	unrelated	distantly_related	v
ἐπιβοηθέω/παραβοηθέω	synonym	synonym	v
ἐπιβοηθέω/καταπλέω	unrelated	same_domain	v
ἐπιβοηθέω/ἐκβοηθέω	synonym	synonym	v
ἐπιβοηθέω/ἔρχομαι	distantly_related	distantly_related	v
ἐπιβοηθέω/ἀθροίζω	unrelated	same_domain	v
ἐπιβοηθέω/πολεμέω	same_domain	same_domain	v
ἐπιβοηθέω/μάχομαι	distantly_related	distantly_related	v
ἐπιβοηθέω/καταλαμβάνω	distantly_related	same_domain	v
προκατασκευάζω/καταμηνύω	unrelated	unrelated	v
προκατασκευάζω/προκαταλαμβάνω	related	distantly_related	v
προκατασκευάζω/ποιέω	distantly_related	related	v
προκατασκευάζω/ἀναλογίζομαι	unrelated	unrelated	v
προκατασκευάζω/φθάζω	related	unrelated	v
προκατασκευάζω/προκατέχω	distantly_related	unrelated	v
προκατασκευάζω/παραιρέω	unrelated	unrelated	v
προκατασκευάζω/ἀντιτίθημι	unrelated	distantly_related	v
προκατασκευάζω/ἀπαρτίζω	related	same_domain	v
προκατασκευάζω/ἑνόω	unrelated	unrelated	v
προκατασκευάζω/διέξειμι	unrelated	unrelated	v
προκατασκευάζω/διεξέρχομαι	unrelated	unrelated	v
προκατασκευάζω/συντέμνω	unrelated	unrelated	v
προκατασκευάζω/ἐκτίθημι	same_domain	same_domain	v
προκατασκευάζω/νομοθετέω	unrelated	unrelated	v
προκατασκευάζω/περιποιέω	distantly_related	same_domain	v
προκατασκευάζω/περιτίθημι	unrelated	same_domain	v
προκατασκευάζω/ἀποδιδράσκω	unrelated	unrelated	v
προκατασκευάζω/κατορθόω	same_domain	distantly_related	v
προκατασκευάζω/ἀντιπαρατίθημι	unrelated	same_domain	v
προκατασκευάζω/συσκευάζω	related	related	v
προκατασκευάζω/διατρίβω	distantly_related	same_domain	v
προκατασκευάζω/ἐπιπάρειμι	unrelated	unrelated	v
προκατασκευάζω/παρασκευάζω	synonym	synonym	v
προκατασκευάζω/χράω	unrelated	same_domain	v
προκατασκευάζω/διασύρω	unrelated	unrelated	v
προκατασκευάζω/λαμβάνω	unrelated	same_domain	v
προκατασκευάζω/προσχράομαι	unrelated	same_domain	v
προκατασκευάζω/πορίζω	distantly_related	same_domain	v
προκατασκευάζω/εὐπορέω	unrelated	unrelated	v
προκατασκευάζω/ἐκδειματόω	unrelated	unrelated	v
προκατασκευάζω/προοικονομέω	synonym	synonym	v
προκατασκευάζω/ὑπεξέρχομαι	unrelated	unrelated	v
προκατασκευάζω/ὑπερτίθημι	distantly_related	same_domain	v
προκατασκευάζω/προοράω	synonym	distantly_related	v
προκατασκευάζω/προλαμβάνω	related	distantly_related	v
ἐξισόω/ὑπερβάλλω	related	distantly_related	v
ἐξισόω/ἐφικνέομαι	unrelated	same_domain	v
ἐξισόω/ἐλλείπω	related	distantly_related	v
ἐξισόω/ἀπολιμπάνω	related	unrelated	v
ἐξισόω/πλεονεκτέω	related	distantly_related	v
ἐξισόω/ἁμιλλάομαι	related	distantly_related	v
ἐξισόω/ἐξισάζω	synonym	synonym	v
ἐξισόω/διήκω	unrelated	same_domain	v
ἐξισόω/προέχω	related	same_domain	v
ἐξισόω/ἰσάζω	synonym	synonym	v
ἐξισόω/νικάω	distantly_related	distantly_related	v
ἐξισόω/αὐξάνω	related	distantly_related	v
ἐξισόω/ἀπολαμβάνω	unrelated	same_domain	v
ἐξισόω/ὑπερέχω	related	distantly_related	v
ἐξισόω/παραλλάσσω	related	distantly_related	v
ἐξισόω/ἀφαιρέω	distantly_related	same_domain	v
ἐξισόω/διαιρέω	distantly_related	same_domain	v
ἐξισόω/προστίθημι	related	distantly_related	v
ἐξισόω/διεξέρχομαι	unrelated	unrelated	v
ἐξισόω/ἔχω	unrelated	same_domain	v
ἐξισόω/χράομαι	unrelated	unrelated	v
ἐξισόω/ἕπομαι	unrelated	distantly_related	v
ἐξισόω/συνάπτω	related	distantly_related	v
ἐξισόω/παρέχω	unrelated	distantly_related	v
ἐξισόω/συμβάλλω	related	distantly_related	v
προαπαντάω/φθάνω	related	related	v
προαπαντάω/καταλαμβάνω	distantly_related	unrelated	v
προαπαντάω/προπέμπω	distantly_related	distantly_related	v
προαπαντάω/πελάζω	related	same_domain	v
προαπαντάω/λῃστεύω	unrelated	unrelated	v
προαπαντάω/διαφίημι	unrelated	unrelated	v
προαπαντάω/στρατοπεδεύω	unrelated	distantly_related	v
προαπαντάω/προμηθέομαι	synonym	related	v
προαπαντάω/ὑστερίζω	related	same_domain	v
προαπαντάω/προτερέω	synonym	related	v
προαπαντάω/ἀνθίστημι	unrelated	distantly_related	v
προαπαντάω/προφθάνω	synonym	related	v
προαπαντάω/ἐπείγω	same_domain	distantly_related	v
προαπαντάω/προσβοηθέω	distantly_related	distantly_related	v
προαπαντάω/προπηδάω	unrelated	distantly_related	v
προαπαντάω/ἡγεμονέω	unrelated	same_domain	v
προαπαντάω/σπεύδω	same_domain	distantly_related	v
προαπαντάω/ἐκτρέχω	unrelated	same_domain	v
προαπαντάω/στέργω	unrelated	unrelated	v
προαπαντάω/ὑπάγω	distantly_related	unrelated	v
προαπαντάω/ἀπαντάω	synonym	related	v
προαπαντάω/παραθαρσύνω	unrelated	unrelated	v
προαπαντάω/ἀποχωρέω	distantly_related	same_domain	v
προαπαντάω/ἐκπέμπω	distantly_related	same_domain	v
προαπαντάω/καταμένω	unrelated	same_domain	v
προαπαντάω/περαιόω	unrelated	same_domain	v
προαπαντάω/προσβάλλω	distantly_related	same_domain	v
προαπαντάω/φεύγω	unrelated	unrelated	v
προαπαντάω/ὑπαντάω	synonym	related	v
προαπαντάω/ἀντιτάσσω	unrelated	same_domain	v
προαπαντάω/ἀνείργω	unrelated	same_domain	v
προαπαντάω/συμμαχέω	unrelated	same_domain	v
προαπαντάω/ὑποχωρέω	unrelated	same_domain	v
προαπαντάω/προκαταλαμβάνω	related	related	v
ἐπισυντίθημι/ὡροσκοπέω	unrelated	unrelated	v
ἐπισυντίθημι/ἔκκειμαι	unrelated	unrelated	v
ἐπισυντίθημι/πολλαπλασιάζω	related	related	v
ἐπισυντίθημι/πολυπλασιάζω	related	related	v
ἐπισυντίθημι/ὑπερέχω	unrelated	related	v
ἐπισυντίθημι/καταλήγω	unrelated	unrelated	v
ἐπισυντίθημι/περιλείπομαι	unrelated	unrelated	v
ἐπισυντίθημι/προστίθημι	synonym	synonym	v
ἐπισυντίθημι/τουτέστι	unrelated	unrelated	v
ἐπισυντίθημι/διαιρέω	related	same_domain	v
ἐπισυντίθημι/συνανατέλλω	unrelated	distantly_related	v
ἐπισυντίθημι/συντίθημι	synonym	synonym	v
ἐπισυντίθημι/ἀντικατηγορέω	unrelated	unrelated	v
ἐπισυντίθημι/ἐξισάζω	distantly_related	distantly_related	v
ἐπισυντίθημι/μεσουρανέω	unrelated	same_domain	v
ἐπισυντίθημι/συγκρίνω	related	distantly_related	v
ἐπισυντίθημι/μερίζω	related	same_domain	v
ἐπισυντίθημι/συγκαταδύνω	unrelated	related	v
ἐπισυντίθημι/διπλόω	related	distantly_related	v
ἐπισυντίθημι/ἐπιλογίζομαι	unrelated	distantly_related	v
ἐπισυντίθημι/ἀναλαλάζω	unrelated	unrelated	v
ἐπισυντίθημι/διοπτεύω	unrelated	unrelated	v
ἐπισυντίθημι/ἀντιπαρατίθημι	unrelated	related	v
ἐπισυντίθημι/ἐκκρούω	related	unrelated	v
ἐκθειάζω/ἀπάντομαι	unrelated	unrelated	v
ἐκθειάζω/ἐκδιηγέομαι	unrelated	unrelated	v
ἐκθειάζω/θαυμάζω	related	related	v
ἐκθειάζω/σέβω	synonym	related	v
ἐκθειάζω/τιμάω	related	related	v
ἐκθειάζω/ἐγκωμιάζω	related	related	v
ἐκθειάζω/ἀπαθανατίζω	synonym	related	v
ἐκθειάζω/θεολογέω	synonym	same_domain	v
ἐκθειάζω/θρησκεύω	synonym	distantly_related	v
ἐκθειάζω/δημοσιεύω	unrelated	unrelated	v
ἐκθειάζω/μακαρίζω	distantly_related	related	v
ἐκθειάζω/ἀγάζω	related	related	v
ἐκθειάζω/περιλέγω	unrelated	same_domain	v
ἐκθειάζω/ἄγαμαι	related	related	v
ἐκθειάζω/προσκυνέω	synonym	related	v
ἐκθειάζω/ἐπαινέω	related	distantly_related	v
ἐκθειάζω/γηράω	unrelated	same_domain	v
ἐκθειάζω/εὐδαιμονίζω	unrelated	distantly_related	v
ἐκθειάζω/σεμνύνω	related	synonym	v
ἐκθειάζω/καταδείκνυμι	unrelated	same_domain	v
ἐκθειάζω/ἐκφοβέω	unrelated	unrelated	v
ἐκθειάζω/ἐπασκέω	related	same_domain	v
ἐκθειάζω/ἀποδέχομαι	unrelated	same_domain	v
ἐκθειάζω/ἐπιδείκνυμι	unrelated	distantly_related	v
ἐκθειάζω/δυσκολαίνω	unrelated	same_domain	v
ἐκθειάζω/ἀγαπάω	unrelated	related	v
ἐκθειάζω/γεραίρω	related	related	v
ἐκθειάζω/ἀποθαυμάζω	related	related	v
ἐκθειάζω/ἐμφανίζω	unrelated	same_domain	v
ἐκθειάζω/αἱρέομαι	unrelated	same_domain	v
ἐκθειάζω/φιλοφρονέομαι	unrelated	related	v
ἐκθειάζω/μιμέομαι	unrelated	same_domain	v
ἐξοδιάζω/πρόκειμαι	unrelated	unrelated	v
ἐξοδιάζω/χρεωστέω	same_domain	distantly_related	v
ἐξοδιάζω/γυμνασιαρχέω	unrelated	unrelated	v
ἐξοδιάζω/προγράφω	same_domain	unrelated	v
ἐξοδιάζω/ἀποδίδωμι	synonym	related	v
ἐξοδιάζω/διαγράφω	synonym	unrelated	v
ἐξοδιάζω/ὀφείλω	distantly_related	distantly_related	v
ἐξοδιάζω/σημειόω	unrelated	unrelated	v
ἐξοδιάζω/ἀγοράζω	distantly_related	same_domain	v
ἐξοδιάζω/συμφωνέω	unrelated	unrelated	v
ἐξοδιάζω/ἀπαιτέω	related	same_domain	v
ἐξοδιάζω/δίδωμι	distantly_related	distantly_related	v
ἐξοδιάζω/ἀπέχω	related	unrelated	v
ἐξοδιάζω/προσφωνέω	unrelated	unrelated	v
ἐξοδιάζω/πιπράσκω	same_domain	same_domain	v
ἐξοδιάζω/προσοφείλω	distantly_related	distantly_related	v
ἐξοδιάζω/μισθόω	same_domain	related	v
ἐξοδιάζω/δημοσιόω	same_domain	same_domain	v
ἐξοδιάζω/δανείζω	same_domain	distantly_related	v
ἐξοδιάζω/κεφαλαιόω	unrelated	unrelated	v
